ID,Флаг дозвона,Флаг продажи,Расходы,PV,NPV
0,1,0,38,0,-38
1,1,0,174,0,-174
2,0,0,53,0,-53
3,0,0,53,0,-53
4,0,0,64,0,-64
5,1,1,245,2007,1762
6,1,0,63,0,-63
7,0,0,61,0,-61
8,1,0,50,0,-50
9,0,0,27,0,-27
10,1,0,74,0,-74
11,1,0,98,0,-98
12,1,1,213,1274,1061
13,1,0,55,0,-55
14,1,1,91,2017,1926
15,0,0,50,0,-50
16,1,0,8,0,-8
17,0,0,96,0,-96
18,1,0,171,0,-171
19,0,0,9,0,-9
20,0,0,73,0,-73
21,1,1,110,2002,1892
22,0,0,41,0,-41
23,0,0,48,0,-48
24,1,0,84,0,-84
25,0,0,27,0,-27
26,1,1,97,1274,1177
27,1,1,126,1440,1314
28,1,1,159,1366,1207
29,1,0,6,0,-6
30,1,1,273,1852,1579
31,0,0,46,0,-46
32,1,1,429,1317,888
33,1,1,211,1519,1308
34,0,0,17,0,-17
35,1,0,35,0,-35
36,1,0,8,0,-8
37,1,1,370,1724,1354
38,1,1,47,1586,1539
39,1,0,73,0,-73
40,1,1,67,1312,1245
41,1,0,4,0,-4
42,1,1,175,1318,1143
43,1,0,110,0,-110
44,1,0,3,0,-3
45,0,0,28,0,-28
46,0,0,150,0,-150
47,1,0,49,0,-49
48,0,0,7,0,-7
49,1,1,598,1404,806
50,0,0,102,0,-102
51,0,0,0,0,0
52,1,0,69,0,-69
53,1,0,52,0,-52
54,1,1,614,1487,873
55,1,1,522,1358,836
56,0,0,45,0,-45
57,0,0,51,0,-51
58,1,0,78,0,-78
59,1,0,4,0,-4
60,1,1,413,1526,1113
61,0,0,38,0,-38
62,1,0,92,0,-92
63,1,0,82,0,-82
64,0,0,40,0,-40
65,1,1,589,1420,831
66,0,0,58,0,-58
67,0,0,71,0,-71
68,0,0,212,0,-212
69,1,0,31,0,-31
70,0,0,39,0,-39
71,0,0,67,0,-67
72,1,0,5,0,-5
73,0,0,23,0,-23
74,0,0,40,0,-40
75,0,0,15,0,-15
76,1,1,379,1371,992
77,1,1,98,1281,1183
78,0,0,40,0,-40
79,1,1,197,1218,1021
80,1,0,45,0,-45
81,1,0,35,0,-35
82,0,0,12,0,-12
83,0,0,11,0,-11
84,1,0,101,0,-101
85,1,0,58,0,-58
86,1,0,71,0,-71
87,0,0,23,0,-23
88,1,0,59,0,-59
89,0,0,169,0,-169
90,0,0,3,0,-3
91,1,0,30,0,-30
92,1,1,62,1471,1409
93,1,1,186,1227,1041
94,1,0,72,0,-72
95,1,1,1318,1342,24
96,0,0,70,0,-70
97,1,0,41,0,-41
98,0,0,40,0,-40
99,1,0,110,0,-110
100,1,1,516,2086,1570
101,0,0,70,0,-70
102,1,1,36,3152,3116
103,0,0,6,0,-6
104,1,0,16,0,-16
105,0,0,47,0,-47
106,0,0,65,0,-65
107,1,0,71,0,-71
108,1,0,98,0,-98
109,1,0,31,0,-31
110,0,0,49,0,-49
111,1,1,148,1205,1057
112,0,0,50,0,-50
113,0,0,49,0,-49
114,0,0,25,0,-25
115,1,0,134,0,-134
116,1,0,8,0,-8
117,1,0,110,0,-110
118,0,0,16,0,-16
119,1,0,67,0,-67
120,1,1,190,1364,1174
121,1,0,15,0,-15
122,1,1,804,1414,610
123,0,0,58,0,-58
124,0,0,45,0,-45
125,0,0,14,0,-14
126,0,0,55,0,-55
127,0,0,51,0,-51
128,0,0,19,0,-19
129,0,0,48,0,-48
130,1,1,234,1279,1045
131,0,0,20,0,-20
132,0,0,23,0,-23
133,0,0,79,0,-79
134,1,0,32,0,-32
135,0,0,9,0,-9
136,1,0,101,0,-101
137,1,0,69,0,-69
138,1,1,955,1306,351
139,0,0,11,0,-11
140,1,1,400,1427,1027
141,1,0,5,0,-5
142,1,1,782,1323,541
143,1,0,51,0,-51
144,1,1,670,1234,564
145,1,0,17,0,-17
146,0,0,68,0,-68
147,0,0,22,0,-22
148,1,1,206,1288,1082
149,1,1,259,1786,1527
150,1,1,126,1818,1692
151,0,0,60,0,-60
152,0,0,56,0,-56
153,0,0,163,0,-163
154,0,0,50,0,-50
155,0,0,231,0,-231
156,1,1,183,1373,1190
157,0,0,68,0,-68
158,1,1,1441,1466,25
159,1,0,57,0,-57
160,0,0,10,0,-10
161,0,0,17,0,-17
162,0,0,46,0,-46
163,1,0,45,0,-45
164,0,0,36,0,-36
165,1,1,339,1395,1056
166,0,0,23,0,-23
167,0,0,179,0,-179
168,0,0,134,0,-134
169,1,1,1755,1342,-413
170,1,0,94,0,-94
171,1,0,46,0,-46
172,1,0,75,0,-75
173,0,0,46,0,-46
174,0,0,8,0,-8
175,1,0,99,0,-99
176,1,1,272,1285,1013
177,0,0,193,0,-193
178,1,0,168,0,-168
179,1,1,196,1947,1751
180,1,1,361,1468,1107
181,0,0,5,0,-5
182,0,0,66,0,-66
183,0,0,134,0,-134
184,1,0,0,0,0
185,0,0,202,0,-202
186,0,0,4,0,-4
187,0,0,0,0,0
188,1,1,2050,1447,-603
189,0,0,46,0,-46
190,1,1,996,1623,627
191,0,0,11,0,-11
192,0,0,104,0,-104
193,1,0,38,0,-38
194,1,1,331,1216,885
195,1,0,14,0,-14
196,1,1,89,1391,1302
197,1,0,48,0,-48
198,1,1,1332,2325,993
199,0,0,15,0,-15
200,1,0,27,0,-27
201,1,0,4,0,-4
202,1,0,39,0,-39
203,1,0,19,0,-19
204,1,0,28,0,-28
205,1,1,400,1615,1215
206,0,0,75,0,-75
207,1,0,64,0,-64
208,0,0,14,0,-14
209,0,0,64,0,-64
210,0,0,7,0,-7
211,1,0,82,0,-82
212,0,0,12,0,-12
213,1,1,191,1445,1254
214,0,0,21,0,-21
215,0,0,8,0,-8
216,1,1,53,1253,1200
217,1,1,1968,1244,-724
218,1,0,8,0,-8
219,0,0,111,0,-111
220,1,0,25,0,-25
221,0,0,23,0,-23
222,1,0,152,0,-152
223,0,0,17,0,-17
224,0,0,7,0,-7
225,0,0,31,0,-31
226,1,1,444,1383,939
227,0,0,134,0,-134
228,1,1,614,1504,890
229,1,0,120,0,-120
230,1,1,799,1580,781
231,0,0,107,0,-107
232,0,0,12,0,-12
233,1,0,73,0,-73
234,1,0,8,0,-8
235,1,0,31,0,-31
236,1,0,97,0,-97
237,1,0,126,0,-126
238,0,0,45,0,-45
239,1,1,804,1579,775
240,1,0,63,0,-63
241,0,0,41,0,-41
242,1,0,44,0,-44
243,1,1,916,1451,535
244,1,1,566,1658,1092
245,1,0,56,0,-56
246,0,0,174,0,-174
247,1,1,777,1200,423
248,0,0,10,0,-10
249,1,1,521,1249,728
250,1,0,16,0,-16
251,1,0,29,0,-29
252,0,0,43,0,-43
253,0,0,23,0,-23
254,0,0,133,0,-133
255,1,0,58,0,-58
256,0,0,124,0,-124
257,1,0,40,0,-40
258,0,0,15,0,-15
259,1,0,23,0,-23
260,1,0,45,0,-45
261,1,1,175,1212,1037
262,0,0,16,0,-16
263,1,1,666,1207,541
264,1,1,93,1308,1215
265,0,0,32,0,-32
266,0,0,101,0,-101
267,0,0,37,0,-37
268,1,1,143,1354,1211
269,1,0,6,0,-6
270,1,0,30,0,-30
271,1,0,31,0,-31
272,0,0,29,0,-29
273,1,0,13,0,-13
274,1,1,865,1451,586
275,1,0,49,0,-49
276,0,0,189,0,-189
277,1,0,13,0,-13
278,1,0,289,0,-289
279,0,0,22,0,-22
280,0,0,69,0,-69
281,0,0,69,0,-69
282,0,0,80,0,-80
283,0,0,7,0,-7
284,1,1,786,1758,972
285,0,0,24,0,-24
286,0,0,27,0,-27
287,0,0,36,0,-36
288,1,1,623,1254,631
289,0,0,35,0,-35
290,1,1,113,1830,1717
291,1,1,1093,2712,1619
292,1,0,18,0,-18
293,0,0,11,0,-11
294,1,1,410,2880,2470
295,1,1,742,1247,505
296,1,1,35,1356,1321
297,1,1,71,1317,1246
298,1,1,227,1354,1127
299,1,0,301,0,-301
300,0,0,56,0,-56
301,1,1,290,1363,1073
302,1,1,76,1244,1168
303,1,1,379,1253,874
304,0,0,5,0,-5
305,0,0,48,0,-48
306,1,1,730,1813,1083
307,1,0,12,0,-12
308,0,0,10,0,-10
309,1,1,448,1498,1050
310,1,1,3120,1613,-1507
311,1,1,234,1327,1093
312,1,1,147,1209,1062
313,1,1,164,1439,1275
314,1,1,908,2782,1874
315,1,1,241,1455,1214
316,0,0,23,0,-23
317,0,0,29,0,-29
318,0,0,108,0,-108
319,1,1,1161,2643,1482
320,1,0,22,0,-22
321,0,0,9,0,-9
322,1,0,1,0,-1
323,1,1,87,1281,1194
324,1,1,1081,1572,491
325,0,0,8,0,-8
326,1,0,44,0,-44
327,1,1,75,1370,1295
328,1,1,331,1928,1597
329,1,0,3,0,-3
330,1,0,77,0,-77
331,0,0,65,0,-65
332,1,0,8,0,-8
333,0,0,22,0,-22
334,0,0,235,0,-235
335,1,1,278,1744,1466
336,0,0,160,0,-160
337,1,0,66,0,-66
338,1,1,803,1206,403
339,1,0,12,0,-12
340,1,0,5,0,-5
341,1,0,181,0,-181
342,1,0,106,0,-106
343,0,0,102,0,-102
344,1,0,102,0,-102
345,1,0,62,0,-62
346,1,1,70,1300,1230
347,1,0,30,0,-30
348,0,0,4,0,-4
349,0,0,23,0,-23
350,0,0,51,0,-51
351,0,0,51,0,-51
352,0,0,83,0,-83
353,1,1,85,3759,3674
354,0,0,118,0,-118
355,1,0,21,0,-21
356,0,0,20,0,-20
357,0,0,1,0,-1
358,0,0,9,0,-9
359,1,1,476,1350,874
360,1,0,47,0,-47
361,1,0,7,0,-7
362,1,1,538,1210,672
363,1,0,39,0,-39
364,1,0,34,0,-34
365,0,0,111,0,-111
366,1,0,107,0,-107
367,1,1,624,1665,1041
368,0,0,47,0,-47
369,1,1,26,1738,1712
370,1,1,142,1689,1547
371,0,0,19,0,-19
372,0,0,97,0,-97
373,1,1,436,1399,963
374,1,1,372,1317,945
375,0,0,71,0,-71
376,0,0,5,0,-5
377,1,1,19,1497,1478
378,1,0,34,0,-34
379,1,0,6,0,-6
380,1,0,22,0,-22
381,0,0,74,0,-74
382,1,0,51,0,-51
383,1,1,740,1218,478
384,1,0,63,0,-63
385,0,0,18,0,-18
386,1,0,30,0,-30
387,0,0,23,0,-23
388,1,0,26,0,-26
389,0,0,65,0,-65
390,0,0,53,0,-53
391,0,0,50,0,-50
392,1,0,33,0,-33
393,1,0,7,0,-7
394,1,1,992,1218,226
395,0,0,4,0,-4
396,0,0,35,0,-35
397,0,0,230,0,-230
398,1,1,976,1480,504
399,0,0,56,0,-56
400,1,0,318,0,-318
401,1,1,86,1400,1314
402,0,0,112,0,-112
403,1,0,7,0,-7
404,1,1,336,1280,944
405,1,1,392,1598,1206
406,0,0,87,0,-87
407,1,0,59,0,-59
408,0,0,36,0,-36
409,0,0,43,0,-43
410,0,0,16,0,-16
411,1,1,294,2468,2174
412,1,1,95,1203,1108
413,1,0,26,0,-26
414,1,1,292,1434,1142
415,1,0,57,0,-57
416,1,0,58,0,-58
417,1,0,1,0,-1
418,1,0,33,0,-33
419,1,1,291,1681,1390
420,1,0,8,0,-8
421,0,0,11,0,-11
422,0,0,46,0,-46
423,1,0,52,0,-52
424,0,0,76,0,-76
425,0,0,5,0,-5
426,1,0,1,0,-1
427,0,0,92,0,-92
428,1,0,40,0,-40
429,1,0,5,0,-5
430,0,0,46,0,-46
431,1,0,180,0,-180
432,1,1,418,1243,825
433,0,0,3,0,-3
434,1,1,133,1209,1076
435,0,0,52,0,-52
436,1,1,50,1346,1296
437,1,0,118,0,-118
438,1,1,78,1553,1475
439,1,1,557,1335,778
440,1,1,343,1581,1238
441,1,1,277,1289,1012
442,1,1,26,1386,1360
443,1,0,7,0,-7
444,0,0,37,0,-37
445,1,1,285,1494,1209
446,0,0,8,0,-8
447,0,0,13,0,-13
448,1,1,405,1339,934
449,0,0,1,0,-1
450,0,0,21,0,-21
451,1,1,273,1219,946
452,0,0,50,0,-50
453,1,0,5,0,-5
454,0,0,60,0,-60
455,1,1,1482,1292,-190
456,1,1,1944,1275,-669
457,0,0,63,0,-63
458,1,1,786,1223,437
459,1,1,113,1728,1615
460,1,0,55,0,-55
461,0,0,14,0,-14
462,1,1,2030,1360,-670
463,1,1,499,1292,793
464,1,0,89,0,-89
465,0,0,10,0,-10
466,1,1,86,1319,1233
467,0,0,77,0,-77
468,0,0,50,0,-50
469,1,1,409,1463,1054
470,1,0,227,0,-227
471,1,1,1013,1831,818
472,0,0,19,0,-19
473,0,0,3,0,-3
474,1,1,928,1238,310
475,1,0,6,0,-6
476,1,1,279,1257,978
477,0,0,119,0,-119
478,1,0,10,0,-10
479,1,1,184,1819,1635
480,1,0,25,0,-25
481,1,0,26,0,-26
482,1,0,44,0,-44
483,1,0,70,0,-70
484,1,0,54,0,-54
485,1,1,1020,1347,327
486,1,0,140,0,-140
487,1,0,122,0,-122
488,1,1,735,1256,521
489,0,0,25,0,-25
490,1,1,349,1615,1266
491,0,0,21,0,-21
492,1,0,105,0,-105
493,1,0,9,0,-9
494,0,0,75,0,-75
495,0,0,6,0,-6
496,0,0,74,0,-74
497,0,0,75,0,-75
498,0,0,172,0,-172
499,1,1,401,1207,806
500,1,1,1260,1519,259
501,0,0,21,0,-21
502,0,0,0,0,0
503,1,1,231,1320,1089
504,0,0,12,0,-12
505,1,1,46,1215,1169
506,1,0,29,0,-29
507,0,0,3,0,-3
508,1,0,19,0,-19
509,0,0,92,0,-92
510,1,0,19,0,-19
511,1,1,121,2026,1905
512,1,0,31,0,-31
513,1,1,152,1625,1473
514,0,0,127,0,-127
515,0,0,89,0,-89
516,1,1,387,6123,5736
517,1,0,94,0,-94
518,1,1,54,1457,1403
519,1,1,136,1501,1365
520,0,0,18,0,-18
521,0,0,8,0,-8
522,1,1,813,1267,454
523,1,1,119,1242,1123
524,1,1,277,1795,1518
525,0,0,30,0,-30
526,1,1,1196,1728,532
527,0,0,48,0,-48
528,0,0,52,0,-52
529,1,1,165,1634,1469
530,1,0,46,0,-46
531,0,0,9,0,-9
532,1,0,56,0,-56
533,0,0,167,0,-167
534,0,0,83,0,-83
535,1,0,0,0,0
536,0,0,86,0,-86
537,0,0,88,0,-88
538,0,0,14,0,-14
539,1,1,1546,1625,79
540,1,0,0,0,0
541,1,1,430,1933,1503
542,1,1,953,1475,522
543,0,0,5,0,-5
544,0,0,22,0,-22
545,1,1,1100,1231,131
546,1,0,41,0,-41
547,1,0,120,0,-120
548,0,0,15,0,-15
549,0,0,93,0,-93
550,1,1,81,2474,2393
551,1,1,1813,2260,447
552,1,0,125,0,-125
553,1,0,4,0,-4
554,1,1,410,1203,793
555,1,1,690,1429,739
556,0,0,56,0,-56
557,0,0,21,0,-21
558,1,0,59,0,-59
559,1,0,26,0,-26
560,0,0,38,0,-38
561,0,0,14,0,-14
562,1,0,6,0,-6
563,1,0,45,0,-45
564,1,0,45,0,-45
565,1,1,952,2899,1947
566,0,0,50,0,-50
567,0,0,20,0,-20
568,1,1,1175,1527,352
569,1,0,24,0,-24
570,1,1,594,1678,1084
571,1,0,1,0,-1
572,1,0,189,0,-189
573,1,0,133,0,-133
574,1,0,1,0,-1
575,0,0,5,0,-5
576,0,0,21,0,-21
577,1,1,796,1663,867
578,1,0,24,0,-24
579,1,1,686,1451,765
580,1,0,13,0,-13
581,1,0,24,0,-24
582,1,0,3,0,-3
583,0,0,9,0,-9
584,1,1,435,1206,771
585,1,1,106,1433,1327
586,1,0,75,0,-75
587,0,0,132,0,-132
588,1,1,776,1488,712
589,1,0,3,0,-3
590,1,1,682,1232,550
591,1,0,16,0,-16
592,1,0,8,0,-8
593,0,0,21,0,-21
594,0,0,23,0,-23
595,1,0,128,0,-128
596,1,0,14,0,-14
597,0,0,50,0,-50
598,1,0,47,0,-47
599,0,0,4,0,-4
600,1,0,104,0,-104
601,0,0,73,0,-73
602,0,0,161,0,-161
603,1,1,30,4621,4591
604,0,0,14,0,-14
605,0,0,21,0,-21
606,1,0,84,0,-84
607,1,1,237,1592,1355
608,0,0,16,0,-16
609,1,1,1867,1422,-445
610,1,0,120,0,-120
611,1,1,609,1889,1280
612,1,0,105,0,-105
613,1,1,17,1474,1457
614,1,1,44,2364,2320
615,0,0,0,0,0
616,1,0,29,0,-29
617,1,1,1037,1746,709
618,1,1,681,1356,675
619,0,0,30,0,-30
620,0,0,6,0,-6
621,0,0,0,0,0
622,0,0,19,0,-19
623,0,0,38,0,-38
624,1,1,886,2419,1533
625,0,0,95,0,-95
626,1,1,452,1297,845
627,0,0,25,0,-25
628,1,1,1217,1541,324
629,0,0,66,0,-66
630,1,0,137,0,-137
631,1,1,1129,1511,382
632,0,0,31,0,-31
633,0,0,113,0,-113
634,0,0,102,0,-102
635,0,0,13,0,-13
636,1,1,454,1314,860
637,1,0,72,0,-72
638,1,1,124,1472,1348
639,0,0,208,0,-208
640,1,0,157,0,-157
641,0,0,115,0,-115
642,1,1,1047,1512,465
643,1,0,137,0,-137
644,1,0,30,0,-30
645,0,0,16,0,-16
646,0,0,20,0,-20
647,1,1,861,1407,546
648,1,1,1393,1509,116
649,0,0,45,0,-45
650,0,0,38,0,-38
651,1,1,158,1656,1498
652,1,1,1924,1308,-616
653,0,0,14,0,-14
654,0,0,9,0,-9
655,0,0,27,0,-27
656,1,0,49,0,-49
657,0,0,110,0,-110
658,0,0,26,0,-26
659,0,0,27,0,-27
660,1,0,51,0,-51
661,1,1,459,1236,777
662,1,1,1740,1273,-467
663,1,1,1097,1302,205
664,1,0,0,0,0
665,0,0,19,0,-19
666,1,0,1,0,-1
667,0,0,18,0,-18
668,1,1,519,2207,1688
669,0,0,13,0,-13
670,0,0,159,0,-159
671,1,0,16,0,-16
672,1,1,1589,2813,1224
673,1,0,53,0,-53
674,1,1,49,1606,1557
675,1,1,220,1330,1110
676,1,1,391,1354,963
677,0,0,1,0,-1
678,1,0,297,0,-297
679,0,0,39,0,-39
680,1,0,6,0,-6
681,0,0,43,0,-43
682,0,0,4,0,-4
683,0,0,46,0,-46
684,1,0,0,0,0
685,0,0,143,0,-143
686,0,0,55,0,-55
687,0,0,34,0,-34
688,1,1,597,4919,4322
689,0,0,43,0,-43
690,1,0,155,0,-155
691,1,0,29,0,-29
692,0,0,7,0,-7
693,1,1,379,1516,1137
694,1,0,79,0,-79
695,0,0,108,0,-108
696,1,1,571,1343,772
697,1,0,13,0,-13
698,0,0,22,0,-22
699,1,0,11,0,-11
700,1,1,294,2102,1808
701,1,1,472,1761,1289
702,0,0,1,0,-1
703,1,0,4,0,-4
704,1,0,44,0,-44
705,0,0,16,0,-16
706,1,0,24,0,-24
707,1,0,35,0,-35
708,0,0,111,0,-111
709,1,0,20,0,-20
710,0,0,57,0,-57
711,0,0,46,0,-46
712,1,1,1615,1422,-193
713,1,0,48,0,-48
714,1,1,517,1256,739
715,1,1,176,2318,2142
716,1,1,1121,1693,572
717,0,0,133,0,-133
718,1,0,57,0,-57
719,0,0,47,0,-47
720,1,1,699,1323,624
721,1,1,87,1365,1278
722,0,0,33,0,-33
723,1,1,261,1374,1113
724,1,0,129,0,-129
725,1,0,3,0,-3
726,1,0,21,0,-21
727,0,0,58,0,-58
728,0,0,18,0,-18
729,0,0,26,0,-26
730,1,1,133,3383,3250
731,1,0,34,0,-34
732,1,1,160,1284,1124
733,1,0,9,0,-9
734,0,0,1,0,-1
735,1,0,94,0,-94
736,0,0,200,0,-200
737,1,1,983,1357,374
738,1,0,36,0,-36
739,1,1,1312,2000,688
740,1,1,458,1286,828
741,1,0,15,0,-15
742,1,1,362,1217,855
743,0,0,20,0,-20
744,0,0,13,0,-13
745,1,1,529,3660,3131
746,1,0,24,0,-24
747,1,0,97,0,-97
748,1,1,355,1202,847
749,1,0,1,0,-1
750,1,1,17,1265,1248
751,1,0,81,0,-81
752,0,0,7,0,-7
753,1,0,66,0,-66
754,1,1,421,1468,1047
755,1,0,1,0,-1
756,1,1,147,1902,1755
757,1,1,93,1556,1463
758,0,0,76,0,-76
759,1,0,112,0,-112
760,1,0,235,0,-235
761,1,1,1096,1430,334
762,1,0,21,0,-21
763,0,0,82,0,-82
764,1,0,25,0,-25
765,1,1,101,1219,1118
766,0,0,13,0,-13
767,0,0,5,0,-5
768,1,1,2129,1864,-265
769,1,1,892,1469,577
770,0,0,66,0,-66
771,0,0,67,0,-67
772,0,0,0,0,0
773,1,1,356,1374,1018
774,0,0,33,0,-33
775,1,1,1431,1509,78
776,0,0,57,0,-57
777,1,0,7,0,-7
778,0,0,11,0,-11
779,0,0,125,0,-125
780,1,1,983,1605,622
781,1,0,39,0,-39
782,1,1,859,2032,1173
783,1,0,64,0,-64
784,0,0,2,0,-2
785,1,0,23,0,-23
786,1,0,8,0,-8
787,1,1,1092,1682,590
788,1,1,690,1485,795
789,0,0,23,0,-23
790,1,1,301,1302,1001
791,0,0,3,0,-3
792,1,1,682,1690,1008
793,0,0,10,0,-10
794,1,1,123,1442,1319
795,0,0,12,0,-12
796,1,0,74,0,-74
797,1,0,33,0,-33
798,1,1,172,1626,1454
799,0,0,16,0,-16
800,0,0,130,0,-130
801,1,1,330,1288,958
802,1,0,55,0,-55
803,1,0,2,0,-2
804,1,0,38,0,-38
805,0,0,92,0,-92
806,1,1,166,1328,1162
807,1,0,1,0,-1
808,0,0,180,0,-180
809,1,1,18,1232,1214
810,1,0,179,0,-179
811,1,0,5,0,-5
812,0,0,105,0,-105
813,0,0,97,0,-97
814,0,0,43,0,-43
815,1,1,951,1213,262
816,1,1,402,1334,932
817,0,0,62,0,-62
818,1,0,8,0,-8
819,0,0,60,0,-60
820,1,0,30,0,-30
821,1,1,1469,1241,-228
822,1,0,32,0,-32
823,1,1,1857,1376,-481
824,1,0,25,0,-25
825,1,0,17,0,-17
826,1,0,36,0,-36
827,0,0,11,0,-11
828,1,1,144,1251,1107
829,0,0,41,0,-41
830,1,1,381,1538,1157
831,1,1,62,1344,1282
832,1,1,569,1796,1227
833,1,1,83,1261,1178
834,0,0,56,0,-56
835,0,0,86,0,-86
836,0,0,95,0,-95
837,1,1,596,1386,790
838,1,1,148,1235,1087
839,0,0,4,0,-4
840,0,0,18,0,-18
841,1,0,26,0,-26
842,0,0,103,0,-103
843,0,0,6,0,-6
844,0,0,3,0,-3
845,1,0,19,0,-19
846,0,0,86,0,-86
847,1,0,8,0,-8
848,0,0,123,0,-123
849,1,0,54,0,-54
850,1,1,1266,1527,261
851,0,0,0,0,0
852,0,0,8,0,-8
853,1,0,6,0,-6
854,1,0,109,0,-109
855,1,0,17,0,-17
856,0,0,35,0,-35
857,1,1,843,1212,369
858,1,0,33,0,-33
859,0,0,29,0,-29
860,0,0,31,0,-31
861,1,0,72,0,-72
862,0,0,146,0,-146
863,1,0,15,0,-15
864,1,1,765,1332,567
865,0,0,20,0,-20
866,1,0,94,0,-94
867,1,1,327,1210,883
868,1,1,412,1479,1067
869,0,0,15,0,-15
870,0,0,8,0,-8
871,0,0,193,0,-193
872,1,0,36,0,-36
873,0,0,24,0,-24
874,1,0,134,0,-134
875,0,0,4,0,-4
876,0,0,6,0,-6
877,0,0,18,0,-18
878,0,0,8,0,-8
879,0,0,16,0,-16
880,0,0,31,0,-31
881,1,1,119,3262,3143
882,1,1,641,1425,784
883,1,1,351,2161,1810
884,1,0,7,0,-7
885,1,1,414,1546,1132
886,1,1,396,1255,859
887,1,0,197,0,-197
888,1,0,149,0,-149
889,1,0,40,0,-40
890,1,1,1799,2124,325
891,0,0,42,0,-42
892,0,0,81,0,-81
893,1,0,91,0,-91
894,1,1,18,1212,1194
895,0,0,65,0,-65
896,0,0,1,0,-1
897,0,0,18,0,-18
898,0,0,78,0,-78
899,0,0,32,0,-32
900,0,0,87,0,-87
901,0,0,24,0,-24
902,1,1,667,1548,881
903,1,0,52,0,-52
904,1,0,128,0,-128
905,1,0,76,0,-76
906,1,1,570,1204,634
907,0,0,0,0,0
908,1,0,9,0,-9
909,0,0,34,0,-34
910,1,1,472,1323,851
911,1,0,56,0,-56
912,0,0,54,0,-54
913,0,0,118,0,-118
914,1,0,21,0,-21
915,1,0,13,0,-13
916,1,1,838,1641,803
917,1,0,75,0,-75
918,1,1,157,1416,1259
919,1,0,29,0,-29
920,0,0,2,0,-2
921,1,1,515,1226,711
922,0,0,22,0,-22
923,0,0,80,0,-80
924,1,1,341,1278,937
925,1,1,710,1381,671
926,0,0,24,0,-24
927,1,1,181,1472,1291
928,0,0,78,0,-78
929,1,0,4,0,-4
930,0,0,62,0,-62
931,1,1,1319,2247,928
932,1,0,35,0,-35
933,1,1,111,1839,1728
934,0,0,85,0,-85
935,0,0,16,0,-16
936,0,0,7,0,-7
937,1,0,7,0,-7
938,0,0,61,0,-61
939,1,0,21,0,-21
940,1,0,6,0,-6
941,0,0,47,0,-47
942,0,0,40,0,-40
943,0,0,43,0,-43
944,1,1,567,1258,691
945,0,0,63,0,-63
946,1,0,26,0,-26
947,1,0,32,0,-32
948,1,1,631,1239,608
949,1,1,253,2027,1774
950,0,0,6,0,-6
951,1,0,143,0,-143
952,1,1,986,1416,430
953,0,0,14,0,-14
954,1,0,58,0,-58
955,1,0,100,0,-100
956,1,1,535,1632,1097
957,0,0,28,0,-28
958,0,0,63,0,-63
959,0,0,19,0,-19
960,1,0,31,0,-31
961,1,0,4,0,-4
962,0,0,79,0,-79
963,0,0,44,0,-44
964,1,0,55,0,-55
965,1,0,53,0,-53
966,0,0,148,0,-148
967,1,1,442,1326,884
968,1,0,10,0,-10
969,1,1,1755,1319,-436
970,0,0,16,0,-16
971,1,1,766,1488,722
972,1,1,229,1350,1121
973,0,0,32,0,-32
974,1,0,128,0,-128
975,1,0,8,0,-8
976,1,0,116,0,-116
977,1,0,12,0,-12
978,1,0,60,0,-60
979,0,0,39,0,-39
980,0,0,32,0,-32
981,0,0,92,0,-92
982,1,0,149,0,-149
983,1,0,34,0,-34
984,1,0,27,0,-27
985,1,1,515,1706,1191
986,1,1,54,1507,1453
987,1,1,721,2289,1568
988,1,0,24,0,-24
989,1,1,142,1398,1256
990,1,0,72,0,-72
991,1,0,68,0,-68
992,0,0,6,0,-6
993,1,1,654,1453,799
994,0,0,35,0,-35
995,1,1,1034,1289,255
996,1,0,53,0,-53
997,1,0,26,0,-26
998,0,0,67,0,-67
999,1,1,1250,3176,1926
1000,0,0,114,0,-114
1001,0,0,76,0,-76
1002,1,1,400,1524,1124
1003,1,0,55,0,-55
1004,1,1,303,1264,961
1005,0,0,20,0,-20
1006,1,0,78,0,-78
1007,1,0,12,0,-12
1008,1,0,90,0,-90
1009,1,0,15,0,-15
1010,0,0,36,0,-36
1011,1,0,14,0,-14
1012,1,1,1142,1218,76
1013,0,0,84,0,-84
1014,0,0,24,0,-24
1015,1,1,481,1253,772
1016,0,0,120,0,-120
1017,0,0,67,0,-67
1018,1,0,14,0,-14
1019,1,1,750,1310,560
1020,1,1,81,1726,1645
1021,0,0,3,0,-3
1022,1,1,260,1815,1555
1023,0,0,156,0,-156
1024,0,0,44,0,-44
1025,1,0,52,0,-52
1026,1,0,54,0,-54
1027,1,0,9,0,-9
1028,0,0,12,0,-12
1029,0,0,32,0,-32
1030,1,0,75,0,-75
1031,1,0,35,0,-35
1032,1,1,247,1624,1377
1033,1,1,649,2585,1936
1034,1,1,159,1394,1235
1035,1,1,814,1437,623
1036,1,0,5,0,-5
1037,0,0,126,0,-126
1038,0,0,22,0,-22
1039,1,0,41,0,-41
1040,1,1,1900,1381,-519
1041,1,0,174,0,-174
1042,1,0,16,0,-16
1043,0,0,24,0,-24
1044,1,0,94,0,-94
1045,1,1,247,1996,1749
1046,0,0,28,0,-28
1047,1,1,208,1291,1083
1048,1,0,23,0,-23
1049,1,0,0,0,0
1050,0,0,26,0,-26
1051,1,1,954,1867,913
1052,0,0,69,0,-69
1053,1,0,28,0,-28
1054,1,0,166,0,-166
1055,1,0,66,0,-66
1056,1,1,577,1454,877
1057,1,0,67,0,-67
1058,1,1,935,1515,580
1059,0,0,15,0,-15
1060,1,1,1139,1379,240
1061,1,1,172,1952,1780
1062,1,1,785,1201,416
1063,1,1,92,1380,1288
1064,0,0,22,0,-22
1065,0,0,83,0,-83
1066,0,0,31,0,-31
1067,0,0,118,0,-118
1068,1,0,43,0,-43
1069,1,1,1147,1252,105
1070,0,0,161,0,-161
1071,1,0,37,0,-37
1072,1,1,856,4881,4025
1073,1,0,50,0,-50
1074,0,0,53,0,-53
1075,1,1,289,1949,1660
1076,1,1,736,1439,703
1077,1,1,98,1385,1287
1078,0,0,4,0,-4
1079,1,1,758,1308,550
1080,1,0,39,0,-39
1081,0,0,8,0,-8
1082,1,1,1011,1230,219
1083,1,0,23,0,-23
1084,0,0,31,0,-31
1085,1,1,162,1869,1707
1086,1,0,7,0,-7
1087,0,0,50,0,-50
1088,0,0,0,0,0
1089,1,1,23,1891,1868
1090,0,0,97,0,-97
1091,0,0,63,0,-63
1092,1,0,78,0,-78
1093,0,0,66,0,-66
1094,1,1,240,1261,1021
1095,0,0,280,0,-280
1096,1,1,729,1317,588
1097,0,0,57,0,-57
1098,0,0,125,0,-125
1099,1,1,189,1352,1163
1100,1,0,26,0,-26
1101,1,0,22,0,-22
1102,1,0,44,0,-44
1103,1,1,1384,1218,-166
1104,0,0,64,0,-64
1105,0,0,36,0,-36
1106,0,0,22,0,-22
1107,1,0,58,0,-58
1108,1,1,26,1481,1455
1109,1,1,160,1247,1087
1110,1,1,652,1306,654
1111,0,0,229,0,-229
1112,1,1,130,1554,1424
1113,0,0,39,0,-39
1114,0,0,60,0,-60
1115,0,0,130,0,-130
1116,1,1,843,1628,785
1117,1,1,263,1220,957
1118,0,0,11,0,-11
1119,1,1,365,1690,1325
1120,0,0,32,0,-32
1121,0,0,7,0,-7
1122,0,0,10,0,-10
1123,0,0,50,0,-50
1124,1,1,767,1316,549
1125,1,0,53,0,-53
1126,1,1,1045,1224,179
1127,0,0,57,0,-57
1128,1,0,4,0,-4
1129,1,1,1480,1234,-246
1130,0,0,6,0,-6
1131,1,0,158,0,-158
1132,0,0,1,0,-1
1133,1,1,367,1271,904
1134,1,1,810,1252,442
1135,1,0,52,0,-52
1136,0,0,21,0,-21
1137,1,1,746,1678,932
1138,0,0,23,0,-23
1139,1,1,813,1834,1021
1140,1,1,736,1234,498
1141,0,0,2,0,-2
1142,1,0,1,0,-1
1143,0,0,348,0,-348
1144,1,1,381,1476,1095
1145,1,1,114,2096,1982
1146,0,0,8,0,-8
1147,1,0,64,0,-64
1148,1,0,81,0,-81
1149,0,0,6,0,-6
1150,0,0,37,0,-37
1151,0,0,34,0,-34
1152,0,0,45,0,-45
1153,0,0,0,0,0
1154,1,0,60,0,-60
1155,1,0,14,0,-14
1156,1,0,49,0,-49
1157,1,0,26,0,-26
1158,0,0,36,0,-36
1159,0,0,29,0,-29
1160,0,0,105,0,-105
1161,1,0,32,0,-32
1162,1,1,187,1401,1214
1163,0,0,93,0,-93
1164,0,0,22,0,-22
1165,0,0,37,0,-37
1166,1,1,514,1203,689
1167,0,0,3,0,-3
1168,1,1,1126,1350,224
1169,1,1,756,1312,556
1170,1,0,2,0,-2
1171,0,0,19,0,-19
1172,0,0,37,0,-37
1173,0,0,7,0,-7
1174,1,1,160,2580,2420
1175,1,0,36,0,-36
1176,1,0,9,0,-9
1177,0,0,75,0,-75
1178,0,0,0,0,0
1179,1,0,6,0,-6
1180,0,0,0,0,0
1181,0,0,146,0,-146
1182,0,0,4,0,-4
1183,1,1,1555,1252,-303
1184,1,1,408,2510,2102
1185,1,1,107,1316,1209
1186,0,0,109,0,-109
1187,1,1,394,1330,936
1188,1,1,547,1282,735
1189,0,0,5,0,-5
1190,1,1,964,1206,242
1191,1,0,38,0,-38
1192,1,0,21,0,-21
1193,1,0,24,0,-24
1194,0,0,14,0,-14
1195,0,0,55,0,-55
1196,0,0,169,0,-169
1197,0,0,249,0,-249
1198,1,0,5,0,-5
1199,1,0,24,0,-24
1200,1,0,33,0,-33
1201,0,0,8,0,-8
1202,0,0,140,0,-140
1203,1,1,938,1832,894
1204,1,1,86,1202,1116
1205,0,0,18,0,-18
1206,1,1,75,1383,1308
1207,0,0,18,0,-18
1208,1,0,28,0,-28
1209,0,0,42,0,-42
1210,0,0,63,0,-63
1211,0,0,89,0,-89
1212,0,0,43,0,-43
1213,1,1,631,1332,701
1214,0,0,32,0,-32
1215,1,0,10,0,-10
1216,1,1,345,1226,881
1217,1,1,288,1703,1415
1218,0,0,18,0,-18
1219,1,0,20,0,-20
1220,0,0,36,0,-36
1221,0,0,77,0,-77
1222,0,0,27,0,-27
1223,1,1,156,1216,1060
1224,0,0,81,0,-81
1225,0,0,67,0,-67
1226,1,0,59,0,-59
1227,0,0,5,0,-5
1228,1,0,52,0,-52
1229,0,0,20,0,-20
1230,0,0,8,0,-8
1231,0,0,25,0,-25
1232,0,0,49,0,-49
1233,1,1,192,1257,1065
1234,1,0,6,0,-6
1235,1,1,382,1685,1303
1236,1,0,24,0,-24
1237,0,0,23,0,-23
1238,1,0,6,0,-6
1239,1,0,62,0,-62
1240,1,1,292,1293,1001
1241,1,0,70,0,-70
1242,1,0,20,0,-20
1243,1,1,1316,1940,624
1244,1,0,22,0,-22
1245,1,1,54,1228,1174
1246,0,0,79,0,-79
1247,0,0,70,0,-70
1248,0,0,31,0,-31
1249,1,0,6,0,-6
1250,1,0,10,0,-10
1251,0,0,0,0,0
1252,0,0,68,0,-68
1253,0,0,8,0,-8
1254,1,0,23,0,-23
1255,1,1,549,1846,1297
1256,1,1,825,1222,397
1257,1,0,19,0,-19
1258,0,0,2,0,-2
1259,0,0,92,0,-92
1260,1,0,39,0,-39
1261,1,0,43,0,-43
1262,0,0,19,0,-19
1263,0,0,16,0,-16
1264,0,0,18,0,-18
1265,1,1,1757,1287,-470
1266,0,0,53,0,-53
1267,1,1,249,1203,954
1268,1,0,7,0,-7
1269,1,1,76,1429,1353
1270,1,1,483,1337,854
1271,1,1,420,3046,2626
1272,1,1,120,1362,1242
1273,0,0,257,0,-257
1274,0,0,224,0,-224
1275,1,1,62,4088,4026
1276,1,0,12,0,-12
1277,1,0,60,0,-60
1278,0,0,31,0,-31
1279,1,1,41,1520,1479
1280,1,0,141,0,-141
1281,1,0,66,0,-66
1282,1,1,337,2233,1896
1283,0,0,31,0,-31
1284,1,0,65,0,-65
1285,0,0,14,0,-14
1286,0,0,67,0,-67
1287,1,0,102,0,-102
1288,0,0,28,0,-28
1289,1,1,426,1233,807
1290,1,1,2073,2033,-40
1291,1,1,695,1344,649
1292,1,0,87,0,-87
1293,1,0,5,0,-5
1294,1,0,6,0,-6
1295,1,1,2444,1283,-1161
1296,1,0,104,0,-104
1297,1,0,138,0,-138
1298,0,0,13,0,-13
1299,1,1,164,1273,1109
1300,1,1,1021,1244,223
1301,1,1,629,1770,1141
1302,1,1,930,1263,333
1303,1,1,954,1238,284
1304,1,0,160,0,-160
1305,1,1,143,2241,2098
1306,1,0,25,0,-25
1307,1,1,722,1206,484
1308,1,1,1691,1293,-398
1309,0,0,74,0,-74
1310,1,0,8,0,-8
1311,0,0,31,0,-31
1312,0,0,38,0,-38
1313,1,0,57,0,-57
1314,0,0,16,0,-16
1315,1,1,191,1368,1177
1316,1,0,102,0,-102
1317,1,1,175,1217,1042
1318,1,1,200,1466,1266
1319,0,0,91,0,-91
1320,1,0,91,0,-91
1321,1,1,375,2160,1785
1322,1,1,485,1347,862
1323,1,1,369,1612,1243
1324,1,1,65,1335,1270
1325,1,0,15,0,-15
1326,0,0,25,0,-25
1327,1,1,765,1258,493
1328,1,0,28,0,-28
1329,0,0,0,0,0
1330,1,0,41,0,-41
1331,1,1,1512,1363,-149
1332,0,0,48,0,-48
1333,1,1,483,1223,740
1334,0,0,58,0,-58
1335,1,0,29,0,-29
1336,1,0,208,0,-208
1337,1,0,7,0,-7
1338,1,0,0,0,0
1339,1,1,170,1251,1081
1340,1,1,93,2340,2247
1341,1,1,587,1379,792
1342,1,1,139,1279,1140
1343,1,0,101,0,-101
1344,1,0,50,0,-50
1345,1,0,14,0,-14
1346,1,0,9,0,-9
1347,1,1,692,1364,672
1348,1,0,24,0,-24
1349,0,0,44,0,-44
1350,1,1,1303,1208,-95
1351,0,0,34,0,-34
1352,1,1,644,1303,659
1353,0,0,28,0,-28
1354,0,0,9,0,-9
1355,1,0,4,0,-4
1356,0,0,8,0,-8
1357,0,0,84,0,-84
1358,1,0,3,0,-3
1359,0,0,91,0,-91
1360,1,1,127,1674,1547
1361,0,0,47,0,-47
1362,0,0,4,0,-4
1363,1,1,717,1287,570
1364,1,1,587,1209,622
1365,1,1,1067,1646,579
1366,1,0,2,0,-2
1367,1,1,570,1319,749
1368,1,0,65,0,-65
1369,0,0,0,0,0
1370,1,1,2140,1327,-813
1371,1,0,5,0,-5
1372,1,1,767,2225,1458
1373,0,0,22,0,-22
1374,1,0,50,0,-50
1375,1,1,308,3061,2753
1376,0,0,121,0,-121
1377,1,1,435,1617,1182
1378,1,0,14,0,-14
1379,0,0,21,0,-21
1380,1,1,573,2030,1457
1381,1,0,45,0,-45
1382,0,0,119,0,-119
1383,1,1,362,1358,996
1384,1,1,1043,1251,208
1385,1,0,82,0,-82
1386,1,0,134,0,-134
1387,1,0,3,0,-3
1388,0,0,26,0,-26
1389,0,0,55,0,-55
1390,1,1,928,1971,1043
1391,1,0,11,0,-11
1392,1,0,46,0,-46
1393,1,1,314,1447,1133
1394,1,1,1020,1471,451
1395,1,0,66,0,-66
1396,1,1,113,2249,2136
1397,1,0,68,0,-68
1398,0,0,3,0,-3
1399,1,1,754,1350,596
1400,1,0,4,0,-4
1401,0,0,69,0,-69
1402,0,0,32,0,-32
1403,0,0,30,0,-30
1404,0,0,36,0,-36
1405,1,1,826,1309,483
1406,0,0,3,0,-3
1407,0,0,13,0,-13
1408,1,1,26,1534,1508
1409,1,1,200,1802,1602
1410,0,0,6,0,-6
1411,0,0,8,0,-8
1412,1,1,2441,1207,-1234
1413,1,0,56,0,-56
1414,1,0,14,0,-14
1415,1,0,26,0,-26
1416,0,0,197,0,-197
1417,0,0,33,0,-33
1418,0,0,32,0,-32
1419,1,1,295,1631,1336
1420,1,0,22,0,-22
1421,0,0,30,0,-30
1422,1,0,43,0,-43
1423,1,1,1311,1578,267
1424,1,0,27,0,-27
1425,1,0,139,0,-139
1426,0,0,9,0,-9
1427,1,1,869,1513,644
1428,1,0,5,0,-5
1429,0,0,66,0,-66
1430,0,0,76,0,-76
1431,1,1,414,1321,907
1432,1,0,54,0,-54
1433,0,0,75,0,-75
1434,1,0,66,0,-66
1435,1,0,45,0,-45
1436,0,0,2,0,-2
1437,1,1,299,1384,1085
1438,1,0,7,0,-7
1439,1,0,71,0,-71
1440,1,0,16,0,-16
1441,1,0,99,0,-99
1442,1,0,2,0,-2
1443,0,0,87,0,-87
1444,1,1,300,1316,1016
1445,1,1,586,1235,649
1446,0,0,35,0,-35
1447,1,0,162,0,-162
1448,1,1,285,1228,943
1449,1,1,994,1407,413
1450,0,0,36,0,-36
1451,1,1,768,1242,474
1452,1,0,26,0,-26
1453,1,0,80,0,-80
1454,1,1,474,1636,1162
1455,1,1,1079,1494,415
1456,0,0,51,0,-51
1457,1,0,90,0,-90
1458,0,0,7,0,-7
1459,0,0,17,0,-17
1460,1,0,56,0,-56
1461,1,1,1075,1247,172
1462,1,0,12,0,-12
1463,1,0,35,0,-35
1464,0,0,287,0,-287
1465,1,0,6,0,-6
1466,0,0,16,0,-16
1467,1,0,39,0,-39
1468,1,1,179,1662,1483
1469,1,1,349,1923,1574
1470,1,0,15,0,-15
1471,1,0,17,0,-17
1472,1,1,852,1270,418
1473,0,0,13,0,-13
1474,0,0,1,0,-1
1475,0,0,120,0,-120
1476,0,0,11,0,-11
1477,1,0,34,0,-34
1478,1,0,1,0,-1
1479,1,1,527,2408,1881
1480,1,0,249,0,-249
1481,1,1,353,1489,1136
1482,1,0,61,0,-61
1483,1,0,21,0,-21
1484,1,0,57,0,-57
1485,0,0,26,0,-26
1486,1,0,1,0,-1
1487,0,0,36,0,-36
1488,0,0,15,0,-15
1489,1,0,46,0,-46
1490,0,0,21,0,-21
1491,0,0,4,0,-4
1492,0,0,24,0,-24
1493,1,1,71,1274,1203
1494,1,0,61,0,-61
1495,1,1,23,1238,1215
1496,0,0,14,0,-14
1497,1,0,35,0,-35
1498,0,0,5,0,-5
1499,1,1,907,3865,2958
1500,1,0,14,0,-14
1501,1,1,460,1405,945
1502,0,0,3,0,-3
1503,1,1,328,1326,998
1504,1,1,362,2701,2339
1505,1,1,175,2392,2217
1506,0,0,58,0,-58
1507,1,1,1715,1243,-472
1508,1,0,60,0,-60
1509,1,0,54,0,-54
1510,1,1,132,1255,1123
1511,0,0,122,0,-122
1512,1,1,314,1245,931
1513,0,0,13,0,-13
1514,1,0,40,0,-40
1515,1,1,488,1898,1410
1516,0,0,13,0,-13
1517,1,0,47,0,-47
1518,1,1,550,1528,978
1519,1,1,553,1716,1163
1520,1,0,16,0,-16
1521,1,0,7,0,-7
1522,0,0,73,0,-73
1523,1,0,50,0,-50
1524,0,0,12,0,-12
1525,0,0,34,0,-34
1526,1,0,36,0,-36
1527,1,0,12,0,-12
1528,0,0,56,0,-56
1529,1,1,346,1347,1001
1530,0,0,32,0,-32
1531,1,0,41,0,-41
1532,0,0,21,0,-21
1533,1,1,834,1237,403
1534,0,0,223,0,-223
1535,1,0,66,0,-66
1536,0,0,17,0,-17
1537,1,1,305,1310,1005
1538,1,0,40,0,-40
1539,1,1,205,1234,1029
1540,0,0,43,0,-43
1541,1,0,31,0,-31
1542,0,0,58,0,-58
1543,1,1,233,1302,1069
1544,1,0,81,0,-81
1545,1,1,657,1396,739
1546,0,0,3,0,-3
1547,0,0,51,0,-51
1548,0,0,5,0,-5
1549,1,0,15,0,-15
1550,1,0,13,0,-13
1551,0,0,4,0,-4
1552,0,0,149,0,-149
1553,1,1,8,1337,1329
1554,0,0,23,0,-23
1555,1,1,1053,1361,308
1556,0,0,55,0,-55
1557,1,1,79,1253,1174
1558,0,0,5,0,-5
1559,0,0,0,0,0
1560,0,0,121,0,-121
1561,1,0,313,0,-313
1562,1,1,501,1265,764
1563,0,0,141,0,-141
1564,1,1,122,1282,1160
1565,1,0,10,0,-10
1566,1,1,900,1247,347
1567,0,0,41,0,-41
1568,1,1,320,2701,2381
1569,0,0,13,0,-13
1570,1,0,67,0,-67
1571,1,1,780,1310,530
1572,0,0,57,0,-57
1573,0,0,90,0,-90
1574,1,1,192,1548,1356
1575,0,0,0,0,0
1576,0,0,56,0,-56
1577,1,0,67,0,-67
1578,0,0,127,0,-127
1579,1,0,22,0,-22
1580,1,0,7,0,-7
1581,0,0,37,0,-37
1582,0,0,23,0,-23
1583,0,0,3,0,-3
1584,0,0,66,0,-66
1585,0,0,96,0,-96
1586,0,0,192,0,-192
1587,1,1,594,1439,845
1588,1,0,38,0,-38
1589,1,1,212,2970,2758
1590,0,0,27,0,-27
1591,0,0,1,0,-1
1592,1,1,411,1328,917
1593,1,1,171,2308,2137
1594,0,0,130,0,-130
1595,0,0,56,0,-56
1596,0,0,112,0,-112
1597,1,1,519,2112,1593
1598,0,0,7,0,-7
1599,0,0,19,0,-19
1600,1,1,251,1451,1200
1601,0,0,20,0,-20
1602,1,0,163,0,-163
1603,0,0,30,0,-30
1604,1,0,105,0,-105
1605,1,1,328,1221,893
1606,1,1,680,1295,615
1607,1,0,1,0,-1
1608,0,0,47,0,-47
1609,1,1,320,1658,1338
1610,1,1,193,1288,1095
1611,0,0,57,0,-57
1612,1,0,34,0,-34
1613,1,0,156,0,-156
1614,1,1,542,1502,960
1615,1,0,8,0,-8
1616,0,0,75,0,-75
1617,1,1,273,1202,929
1618,1,1,161,1529,1368
1619,0,0,18,0,-18
1620,1,1,270,1274,1004
1621,1,0,0,0,0
1622,1,1,32,1311,1279
1623,0,0,49,0,-49
1624,0,0,5,0,-5
1625,1,0,28,0,-28
1626,0,0,87,0,-87
1627,1,0,76,0,-76
1628,0,0,115,0,-115
1629,0,0,16,0,-16
1630,0,0,41,0,-41
1631,1,0,5,0,-5
1632,1,1,103,2512,2409
1633,1,0,12,0,-12
1634,1,0,1,0,-1
1635,0,0,6,0,-6
1636,1,1,123,1234,1111
1637,0,0,9,0,-9
1638,1,1,91,1274,1183
1639,0,0,61,0,-61
1640,1,1,98,1300,1202
1641,1,0,70,0,-70
1642,1,1,627,1808,1181
1643,1,1,53,1458,1405
1644,0,0,30,0,-30
1645,0,0,13,0,-13
1646,0,0,95,0,-95
1647,0,0,64,0,-64
1648,1,1,168,1484,1316
1649,0,0,49,0,-49
1650,1,0,28,0,-28
1651,0,0,45,0,-45
1652,1,0,57,0,-57
1653,1,0,23,0,-23
1654,1,0,6,0,-6
1655,0,0,41,0,-41
1656,1,1,297,1495,1198
1657,1,1,1194,1273,79
1658,1,1,3097,1485,-1612
1659,0,0,43,0,-43
1660,1,1,1367,1253,-114
1661,1,0,25,0,-25
1662,1,1,429,1466,1037
1663,1,1,317,1596,1279
1664,1,0,7,0,-7
1665,1,0,49,0,-49
1666,1,0,53,0,-53
1667,0,0,47,0,-47
1668,1,0,71,0,-71
1669,1,0,128,0,-128
1670,1,0,50,0,-50
1671,1,0,37,0,-37
1672,0,0,37,0,-37
1673,1,0,30,0,-30
1674,1,0,2,0,-2
1675,0,0,70,0,-70
1676,1,1,239,1373,1134
1677,0,0,37,0,-37
1678,0,0,6,0,-6
1679,0,0,44,0,-44
1680,0,0,49,0,-49
1681,1,1,1209,1308,99
1682,0,0,24,0,-24
1683,1,0,67,0,-67
1684,0,0,61,0,-61
1685,1,1,1542,1594,52
1686,1,0,50,0,-50
1687,0,0,3,0,-3
1688,0,0,77,0,-77
1689,0,0,50,0,-50
1690,0,0,258,0,-258
1691,0,0,10,0,-10
1692,1,0,78,0,-78
1693,0,0,11,0,-11
1694,0,0,34,0,-34
1695,0,0,336,0,-336
1696,1,1,1865,1787,-78
1697,1,0,5,0,-5
1698,1,0,42,0,-42
1699,0,0,33,0,-33
1700,1,1,460,1436,976
1701,0,0,47,0,-47
1702,1,0,26,0,-26
1703,1,1,1741,1848,107
1704,1,1,876,1656,780
1705,1,1,722,1436,714
1706,1,1,468,1322,854
1707,1,0,169,0,-169
1708,1,1,451,4345,3894
1709,0,0,134,0,-134
1710,1,0,75,0,-75
1711,1,0,26,0,-26
1712,0,0,33,0,-33
1713,0,0,19,0,-19
1714,1,1,359,1635,1276
1715,1,0,101,0,-101
1716,1,1,871,1318,447
1717,1,1,588,1708,1120
1718,0,0,15,0,-15
1719,0,0,267,0,-267
1720,0,0,9,0,-9
1721,0,0,9,0,-9
1722,1,0,21,0,-21
1723,1,1,641,1907,1266
1724,1,0,107,0,-107
1725,1,0,79,0,-79
1726,1,1,154,1579,1425
1727,1,0,44,0,-44
1728,1,0,60,0,-60
1729,1,0,21,0,-21
1730,1,1,407,1309,902
1731,0,0,2,0,-2
1732,0,0,39,0,-39
1733,0,0,4,0,-4
1734,1,0,0,0,0
1735,0,0,18,0,-18
1736,1,0,34,0,-34
1737,0,0,2,0,-2
1738,1,1,376,1230,854
1739,1,0,122,0,-122
1740,0,0,61,0,-61
1741,1,0,21,0,-21
1742,1,1,360,1564,1204
1743,0,0,163,0,-163
1744,0,0,40,0,-40
1745,1,0,10,0,-10
1746,1,0,9,0,-9
1747,1,1,371,1501,1130
1748,1,1,100,1341,1241
1749,1,1,83,1399,1316
1750,1,1,1237,1401,164
1751,0,0,5,0,-5
1752,0,0,12,0,-12
1753,0,0,26,0,-26
1754,0,0,42,0,-42
1755,1,1,1335,1548,213
1756,1,1,1181,1366,185
1757,1,0,25,0,-25
1758,0,0,7,0,-7
1759,1,1,168,1840,1672
1760,1,0,61,0,-61
1761,0,0,41,0,-41
1762,1,1,570,1431,861
1763,0,0,11,0,-11
1764,0,0,13,0,-13
1765,1,0,100,0,-100
1766,0,0,3,0,-3
1767,1,1,120,1204,1084
1768,0,0,53,0,-53
1769,1,0,54,0,-54
1770,0,0,141,0,-141
1771,1,1,22,1546,1524
1772,0,0,25,0,-25
1773,1,1,979,1329,350
1774,1,0,14,0,-14
1775,0,0,74,0,-74
1776,1,0,15,0,-15
1777,0,0,76,0,-76
1778,0,0,0,0,0
1779,1,1,1043,2352,1309
1780,1,0,12,0,-12
1781,1,1,319,1543,1224
1782,0,0,13,0,-13
1783,1,0,8,0,-8
1784,1,0,41,0,-41
1785,0,0,24,0,-24
1786,0,0,17,0,-17
1787,1,0,100,0,-100
1788,1,0,27,0,-27
1789,1,0,86,0,-86
1790,0,0,9,0,-9
1791,1,0,40,0,-40
1792,1,0,80,0,-80
1793,1,0,28,0,-28
1794,1,1,519,1584,1065
1795,1,0,26,0,-26
1796,1,0,83,0,-83
1797,1,0,58,0,-58
1798,1,0,100,0,-100
1799,0,0,180,0,-180
1800,1,1,2899,1231,-1668
1801,1,0,49,0,-49
1802,1,0,49,0,-49
1803,0,0,20,0,-20
1804,1,1,912,1318,406
1805,0,0,75,0,-75
1806,1,0,19,0,-19
1807,0,0,20,0,-20
1808,1,0,95,0,-95
1809,1,0,84,0,-84
1810,1,0,31,0,-31
1811,1,1,1037,1364,327
1812,1,1,45,2187,2142
1813,0,0,61,0,-61
1814,1,1,575,1369,794
1815,1,0,51,0,-51
1816,1,0,138,0,-138
1817,1,0,69,0,-69
1818,1,1,455,1347,892
1819,0,0,1,0,-1
1820,1,0,0,0,0
1821,1,0,28,0,-28
1822,1,0,13,0,-13
1823,0,0,69,0,-69
1824,1,1,199,1276,1077
1825,0,0,60,0,-60
1826,0,0,14,0,-14
1827,0,0,25,0,-25
1828,1,0,70,0,-70
1829,1,0,167,0,-167
1830,0,0,166,0,-166
1831,1,0,11,0,-11
1832,1,1,767,1529,762
1833,1,1,566,1484,918
1834,0,0,21,0,-21
1835,1,1,244,2389,2145
1836,1,1,679,1745,1066
1837,1,1,1341,1204,-137
1838,1,0,138,0,-138
1839,1,1,1157,1200,43
1840,1,0,36,0,-36
1841,1,0,8,0,-8
1842,0,0,98,0,-98
1843,0,0,11,0,-11
1844,0,0,5,0,-5
1845,0,0,7,0,-7
1846,0,0,8,0,-8
1847,0,0,12,0,-12
1848,1,1,702,1660,958
1849,1,1,192,1418,1226
1850,1,0,72,0,-72
1851,1,1,384,1286,902
1852,1,1,78,1517,1439
1853,1,0,59,0,-59
1854,1,0,10,0,-10
1855,0,0,14,0,-14
1856,1,1,2400,1258,-1142
1857,0,0,38,0,-38
1858,0,0,75,0,-75
1859,0,0,16,0,-16
1860,1,1,68,1657,1589
1861,1,0,25,0,-25
1862,1,1,662,15290,14628
1863,0,0,22,0,-22
1864,0,0,38,0,-38
1865,0,0,41,0,-41
1866,1,0,15,0,-15
1867,1,0,228,0,-228
1868,1,0,105,0,-105
1869,1,1,2553,1285,-1268
1870,1,0,205,0,-205
1871,1,1,214,1474,1260
1872,0,0,5,0,-5
1873,0,0,86,0,-86
1874,0,0,90,0,-90
1875,1,0,163,0,-163
1876,0,0,0,0,0
1877,1,1,489,8477,7988
1878,1,1,1748,1756,8
1879,0,0,136,0,-136
1880,0,0,20,0,-20
1881,1,0,19,0,-19
1882,1,0,1,0,-1
1883,1,1,184,1412,1228
1884,0,0,4,0,-4
1885,1,1,965,1513,548
1886,0,0,61,0,-61
1887,1,0,75,0,-75
1888,0,0,80,0,-80
1889,1,1,60,1612,1552
1890,1,1,502,1454,952
1891,1,1,59,2277,2218
1892,1,0,46,0,-46
1893,1,1,446,1403,957
1894,1,1,204,1284,1080
1895,1,0,141,0,-141
1896,0,0,39,0,-39
1897,1,0,48,0,-48
1898,0,0,65,0,-65
1899,1,1,919,1704,785
1900,1,0,3,0,-3
1901,1,1,438,2440,2002
1902,1,0,87,0,-87
1903,1,0,62,0,-62
1904,1,0,56,0,-56
1905,1,1,233,1743,1510
1906,0,0,49,0,-49
1907,1,1,346,1609,1263
1908,1,1,59,1330,1271
1909,1,1,1661,1254,-407
1910,1,0,16,0,-16
1911,1,1,272,1237,965
1912,1,0,19,0,-19
1913,1,0,12,0,-12
1914,1,0,12,0,-12
1915,0,0,8,0,-8
1916,1,1,284,2550,2266
1917,0,0,30,0,-30
1918,1,0,4,0,-4
1919,1,0,3,0,-3
1920,1,0,3,0,-3
1921,1,0,86,0,-86
1922,1,1,831,1374,543
1923,1,0,4,0,-4
1924,0,0,93,0,-93
1925,1,0,87,0,-87
1926,1,1,1441,1346,-95
1927,1,1,281,1570,1289
1928,0,0,11,0,-11
1929,0,0,73,0,-73
1930,1,1,664,1434,770
1931,1,1,292,1820,1528
1932,0,0,28,0,-28
1933,1,1,428,2029,1601
1934,0,0,17,0,-17
1935,1,1,185,5445,5260
1936,1,1,253,1597,1344
1937,1,0,20,0,-20
1938,1,0,14,0,-14
1939,1,1,70,1477,1407
1940,0,0,42,0,-42
1941,0,0,34,0,-34
1942,1,1,392,1252,860
1943,1,0,22,0,-22
1944,1,0,114,0,-114
1945,1,0,35,0,-35
1946,1,0,44,0,-44
1947,1,1,342,1366,1024
1948,1,0,58,0,-58
1949,0,0,29,0,-29
1950,0,0,36,0,-36
1951,1,1,279,1610,1331
1952,1,1,874,1515,641
1953,1,1,38,1237,1199
1954,1,0,80,0,-80
1955,1,0,6,0,-6
1956,1,1,304,1235,931
1957,1,1,1022,1825,803
1958,1,1,820,1747,927
1959,0,0,35,0,-35
1960,1,1,100,1339,1239
1961,1,0,117,0,-117
1962,1,0,95,0,-95
1963,1,0,6,0,-6
1964,0,0,17,0,-17
1965,1,1,571,1512,941
1966,0,0,34,0,-34
1967,1,0,91,0,-91
1968,1,0,44,0,-44
1969,0,0,64,0,-64
1970,1,1,21,1636,1615
1971,0,0,5,0,-5
1972,0,0,97,0,-97
1973,1,0,101,0,-101
1974,0,0,13,0,-13
1975,0,0,16,0,-16
1976,1,1,569,1498,929
1977,1,0,87,0,-87
1978,0,0,33,0,-33
1979,0,0,123,0,-123
1980,1,0,13,0,-13
1981,0,0,3,0,-3
1982,1,1,68,1300,1232
1983,0,0,8,0,-8
1984,0,0,3,0,-3
1985,1,1,1506,2721,1215
1986,1,1,540,1546,1006
1987,1,0,23,0,-23
1988,1,1,182,1714,1532
1989,1,1,1044,1202,158
1990,1,0,78,0,-78
1991,1,0,58,0,-58
1992,1,0,8,0,-8
1993,1,1,297,1759,1462
1994,1,0,215,0,-215
1995,0,0,12,0,-12
1996,1,1,15,1302,1287
1997,0,0,34,0,-34
1998,1,1,131,1703,1572
1999,0,0,11,0,-11
2000,1,1,134,1270,1136
2001,0,0,135,0,-135
2002,1,0,32,0,-32
2003,1,1,237,1286,1049
2004,0,0,70,0,-70
2005,1,0,100,0,-100
2006,1,0,110,0,-110
2007,1,1,267,1391,1124
2008,1,0,29,0,-29
2009,0,0,59,0,-59
2010,1,1,428,1240,812
2011,1,1,582,1290,708
2012,1,1,1458,1432,-26
2013,1,1,156,1485,1329
2014,1,1,107,1301,1194
2015,1,1,701,1252,551
2016,0,0,35,0,-35
2017,1,0,61,0,-61
2018,0,0,18,0,-18
2019,0,0,12,0,-12
2020,0,0,42,0,-42
2021,1,0,13,0,-13
2022,0,0,166,0,-166
2023,0,0,47,0,-47
2024,0,0,6,0,-6
2025,1,0,15,0,-15
2026,1,0,33,0,-33
2027,1,1,265,1788,1523
2028,1,1,1252,1333,81
2029,1,1,20,1323,1303
2030,0,0,32,0,-32
2031,1,0,104,0,-104
2032,0,0,0,0,0
2033,1,0,88,0,-88
2034,1,0,126,0,-126
2035,1,1,118,1251,1133
2036,1,0,59,0,-59
2037,0,0,85,0,-85
2038,1,0,26,0,-26
2039,1,0,32,0,-32
2040,1,0,9,0,-9
2041,0,0,5,0,-5
2042,1,0,79,0,-79
2043,1,1,2264,1200,-1064
2044,1,1,1001,1926,925
2045,0,0,41,0,-41
2046,1,0,4,0,-4
2047,1,0,97,0,-97
2048,1,1,226,1728,1502
2049,0,0,19,0,-19
2050,1,1,581,1212,631
2051,0,0,202,0,-202
2052,1,1,1137,1237,100
2053,0,0,8,0,-8
2054,0,0,57,0,-57
2055,0,0,24,0,-24
2056,0,0,19,0,-19
2057,0,0,30,0,-30
2058,1,1,3061,1625,-1436
2059,1,0,71,0,-71
2060,1,0,2,0,-2
2061,1,0,30,0,-30
2062,0,0,15,0,-15
2063,0,0,77,0,-77
2064,0,0,197,0,-197
2065,0,0,58,0,-58
2066,1,1,1570,1323,-247
2067,0,0,33,0,-33
2068,1,1,125,2106,1981
2069,1,1,1023,1922,899
2070,1,0,80,0,-80
2071,0,0,40,0,-40
2072,1,0,40,0,-40
2073,0,0,21,0,-21
2074,0,0,15,0,-15
2075,1,0,34,0,-34
2076,1,0,3,0,-3
2077,0,0,61,0,-61
2078,1,0,18,0,-18
2079,0,0,22,0,-22
2080,0,0,5,0,-5
2081,1,1,1700,1420,-280
2082,1,1,468,1258,790
2083,1,1,824,1471,647
2084,1,0,30,0,-30
2085,1,0,53,0,-53
2086,0,0,59,0,-59
2087,0,0,47,0,-47
2088,1,0,2,0,-2
2089,1,0,58,0,-58
2090,1,0,106,0,-106
2091,0,0,4,0,-4
2092,1,0,23,0,-23
2093,0,0,399,0,-399
2094,0,0,11,0,-11
2095,0,0,26,0,-26
2096,0,0,1,0,-1
2097,0,0,10,0,-10
2098,1,0,24,0,-24
2099,1,1,1007,1223,216
2100,1,1,185,1220,1035
2101,1,0,60,0,-60
2102,1,0,18,0,-18
2103,1,0,5,0,-5
2104,1,0,4,0,-4
2105,1,0,9,0,-9
2106,0,0,15,0,-15
2107,1,1,772,1259,487
2108,1,1,274,2695,2421
2109,0,0,73,0,-73
2110,1,0,122,0,-122
2111,0,0,36,0,-36
2112,0,0,70,0,-70
2113,1,1,296,1246,950
2114,1,0,1,0,-1
2115,1,0,72,0,-72
2116,1,0,7,0,-7
2117,1,1,409,1358,949
2118,1,0,12,0,-12
2119,0,0,25,0,-25
2120,0,0,90,0,-90
2121,0,0,7,0,-7
2122,1,0,128,0,-128
2123,1,0,63,0,-63
2124,1,1,121,1289,1168
2125,1,1,691,1301,610
2126,1,0,7,0,-7
2127,0,0,16,0,-16
2128,1,0,169,0,-169
2129,1,0,41,0,-41
2130,0,0,122,0,-122
2131,0,0,15,0,-15
2132,1,1,441,1237,796
2133,1,1,1498,1325,-173
2134,1,0,57,0,-57
2135,0,0,0,0,0
2136,0,0,38,0,-38
2137,0,0,83,0,-83
2138,0,0,86,0,-86
2139,1,1,549,2069,1520
2140,1,1,685,1450,765
2141,1,0,61,0,-61
2142,1,0,50,0,-50
2143,1,1,455,1222,767
2144,0,0,18,0,-18
2145,0,0,14,0,-14
2146,1,0,27,0,-27
2147,1,1,1290,1878,588
2148,1,1,1386,1355,-31
2149,1,0,37,0,-37
2150,1,0,11,0,-11
2151,1,0,63,0,-63
2152,1,1,531,1512,981
2153,0,0,40,0,-40
2154,0,0,32,0,-32
2155,0,0,17,0,-17
2156,1,0,14,0,-14
2157,1,0,13,0,-13
2158,1,0,3,0,-3
2159,0,0,142,0,-142
2160,0,0,33,0,-33
2161,1,1,1662,1253,-409
2162,1,1,24,1360,1336
2163,1,1,301,1221,920
2164,1,0,15,0,-15
2165,1,0,20,0,-20
2166,1,0,27,0,-27
2167,1,1,210,1246,1036
2168,1,0,64,0,-64
2169,1,0,99,0,-99
2170,1,0,27,0,-27
2171,0,0,102,0,-102
2172,1,0,73,0,-73
2173,1,1,1366,2048,682
2174,0,0,34,0,-34
2175,1,1,16,1400,1384
2176,0,0,3,0,-3
2177,1,0,38,0,-38
2178,1,1,55,1479,1424
2179,0,0,31,0,-31
2180,0,0,41,0,-41
2181,1,0,36,0,-36
2182,1,0,47,0,-47
2183,0,0,89,0,-89
2184,1,1,46,1551,1505
2185,0,0,11,0,-11
2186,1,1,231,1833,1602
2187,1,0,44,0,-44
2188,0,0,56,0,-56
2189,0,0,3,0,-3
2190,1,1,192,1475,1283
2191,1,1,1135,1367,232
2192,0,0,23,0,-23
2193,1,1,259,1777,1518
2194,1,1,953,1686,733
2195,0,0,41,0,-41
2196,0,0,13,0,-13
2197,0,0,5,0,-5
2198,1,1,375,1525,1150
2199,0,0,39,0,-39
2200,0,0,2,0,-2
2201,1,0,45,0,-45
2202,1,1,506,1200,694
2203,1,0,12,0,-12
2204,1,0,55,0,-55
2205,0,0,28,0,-28
2206,1,0,20,0,-20
2207,0,0,5,0,-5
2208,1,1,129,1278,1149
2209,1,0,90,0,-90
2210,0,0,13,0,-13
2211,0,0,50,0,-50
2212,0,0,6,0,-6
2213,1,0,49,0,-49
2214,0,0,51,0,-51
2215,0,0,19,0,-19
2216,0,0,19,0,-19
2217,0,0,102,0,-102
2218,1,0,7,0,-7
2219,0,0,33,0,-33
2220,0,0,5,0,-5
2221,1,0,49,0,-49
2222,0,0,5,0,-5
2223,0,0,70,0,-70
2224,1,0,8,0,-8
2225,1,1,123,1444,1321
2226,0,0,19,0,-19
2227,0,0,5,0,-5
2228,1,0,65,0,-65
2229,0,0,34,0,-34
2230,1,0,16,0,-16
2231,0,0,52,0,-52
2232,0,0,7,0,-7
2233,1,0,2,0,-2
2234,0,0,26,0,-26
2235,1,1,1838,1605,-233
2236,0,0,114,0,-114
2237,0,0,127,0,-127
2238,0,0,20,0,-20
2239,0,0,102,0,-102
2240,0,0,56,0,-56
2241,1,0,20,0,-20
2242,1,0,26,0,-26
2243,1,0,55,0,-55
2244,1,1,1394,1288,-106
2245,1,1,56,1291,1235
2246,1,0,0,0,0
2247,1,1,125,1742,1617
2248,1,0,94,0,-94
2249,1,1,700,1243,543
2250,1,0,44,0,-44
2251,0,0,2,0,-2
2252,1,1,126,1689,1563
2253,1,0,71,0,-71
2254,1,1,379,1389,1010
2255,1,0,14,0,-14
2256,0,0,36,0,-36
2257,0,0,44,0,-44
2258,1,1,1825,1416,-409
2259,1,1,201,1341,1140
2260,1,1,611,1245,634
2261,0,0,2,0,-2
2262,1,0,34,0,-34
2263,1,0,35,0,-35
2264,0,0,21,0,-21
2265,1,0,122,0,-122
2266,1,0,9,0,-9
2267,1,1,666,1253,587
2268,0,0,1,0,-1
2269,1,1,182,1271,1089
2270,1,1,93,2345,2252
2271,1,0,113,0,-113
2272,0,0,22,0,-22
2273,0,0,112,0,-112
2274,1,0,25,0,-25
2275,1,0,188,0,-188
2276,1,1,1235,1451,216
2277,1,0,23,0,-23
2278,1,0,39,0,-39
2279,1,0,27,0,-27
2280,1,1,213,1914,1701
2281,0,0,31,0,-31
2282,0,0,3,0,-3
2283,1,0,54,0,-54
2284,1,1,1243,2167,924
2285,1,1,2153,1254,-899
2286,1,0,106,0,-106
2287,1,0,32,0,-32
2288,1,1,1240,1419,179
2289,0,0,45,0,-45
2290,1,1,124,3295,3171
2291,0,0,61,0,-61
2292,1,1,806,1347,541
2293,1,1,512,1257,745
2294,1,0,0,0,0
2295,1,1,397,2020,1623
2296,0,0,22,0,-22
2297,0,0,12,0,-12
2298,1,0,127,0,-127
2299,0,0,15,0,-15
2300,0,0,78,0,-78
2301,0,0,21,0,-21
2302,0,0,53,0,-53
2303,1,0,39,0,-39
2304,0,0,99,0,-99
2305,1,1,581,1477,896
2306,1,0,15,0,-15
2307,1,0,3,0,-3
2308,0,0,139,0,-139
2309,1,0,53,0,-53
2310,0,0,43,0,-43
2311,0,0,7,0,-7
2312,1,0,83,0,-83
2313,1,1,928,1496,568
2314,1,1,204,1418,1214
2315,1,0,20,0,-20
2316,0,0,5,0,-5
2317,1,0,48,0,-48
2318,0,0,60,0,-60
2319,1,0,12,0,-12
2320,1,0,89,0,-89
2321,1,1,464,1788,1324
2322,1,1,715,1322,607
2323,1,1,1022,1436,414
2324,0,0,9,0,-9
2325,0,0,70,0,-70
2326,1,1,451,1692,1241
2327,1,1,217,1259,1042
2328,1,1,969,1616,647
2329,0,0,33,0,-33
2330,1,0,32,0,-32
2331,1,0,78,0,-78
2332,1,1,706,1203,497
2333,0,0,15,0,-15
2334,1,1,476,2226,1750
2335,1,0,12,0,-12
2336,0,0,60,0,-60
2337,0,0,28,0,-28
2338,1,1,1558,2077,519
2339,0,0,58,0,-58
2340,1,1,1761,1708,-53
2341,1,1,57,1249,1192
2342,1,1,849,1309,460
2343,0,0,10,0,-10
2344,1,1,152,1620,1468
2345,1,0,25,0,-25
2346,1,0,38,0,-38
2347,0,0,58,0,-58
2348,0,0,34,0,-34
2349,0,0,124,0,-124
2350,1,0,2,0,-2
2351,0,0,63,0,-63
2352,1,1,750,1218,468
2353,0,0,68,0,-68
2354,0,0,102,0,-102
2355,1,1,748,1336,588
2356,0,0,128,0,-128
2357,0,0,16,0,-16
2358,0,0,81,0,-81
2359,1,0,24,0,-24
2360,0,0,23,0,-23
2361,1,0,3,0,-3
2362,0,0,21,0,-21
2363,1,1,379,1410,1031
2364,1,1,761,2101,1340
2365,0,0,34,0,-34
2366,1,1,394,1216,822
2367,1,0,72,0,-72
2368,1,0,53,0,-53
2369,0,0,38,0,-38
2370,0,0,74,0,-74
2371,0,0,2,0,-2
2372,1,1,724,1294,570
2373,1,0,25,0,-25
2374,0,0,3,0,-3
2375,1,1,1016,1311,295
2376,1,0,13,0,-13
2377,1,1,306,1314,1008
2378,0,0,37,0,-37
2379,1,1,930,2187,1257
2380,0,0,14,0,-14
2381,0,0,83,0,-83
2382,1,1,1798,2176,378
2383,1,1,231,1617,1386
2384,1,1,462,2307,1845
2385,0,0,48,0,-48
2386,1,1,88,1777,1689
2387,0,0,57,0,-57
2388,0,0,7,0,-7
2389,1,1,569,1388,819
2390,1,0,111,0,-111
2391,1,1,1480,2142,662
2392,1,1,180,1269,1089
2393,1,1,1792,1297,-495
2394,1,0,11,0,-11
2395,0,0,23,0,-23
2396,1,1,1145,1282,137
2397,0,0,23,0,-23
2398,1,0,0,0,0
2399,1,1,227,1224,997
2400,1,0,9,0,-9
2401,0,0,33,0,-33
2402,0,0,135,0,-135
2403,0,0,251,0,-251
2404,1,1,539,2195,1656
2405,0,0,62,0,-62
2406,1,0,19,0,-19
2407,0,0,38,0,-38
2408,1,0,95,0,-95
2409,1,1,1621,1272,-349
2410,0,0,171,0,-171
2411,0,0,43,0,-43
2412,1,1,1218,1570,352
2413,1,0,26,0,-26
2414,0,0,5,0,-5
2415,1,1,40,1218,1178
2416,0,0,5,0,-5
2417,1,1,160,1369,1209
2418,0,0,76,0,-76
2419,1,0,127,0,-127
2420,0,0,61,0,-61
2421,0,0,87,0,-87
2422,0,0,190,0,-190
2423,1,1,60,1454,1394
2424,0,0,78,0,-78
2425,1,0,73,0,-73
2426,0,0,18,0,-18
2427,0,0,21,0,-21
2428,0,0,60,0,-60
2429,1,1,268,1290,1022
2430,1,1,712,1627,915
2431,1,0,44,0,-44
2432,1,1,1567,1274,-293
2433,1,1,264,1662,1398
2434,1,0,47,0,-47
2435,0,0,4,0,-4
2436,0,0,20,0,-20
2437,1,0,22,0,-22
2438,0,0,222,0,-222
2439,0,0,53,0,-53
2440,0,0,1,0,-1
2441,0,0,0,0,0
2442,0,0,17,0,-17
2443,0,0,109,0,-109
2444,1,1,150,1514,1364
2445,1,1,71,1291,1220
2446,1,1,331,1549,1218
2447,0,0,23,0,-23
2448,0,0,40,0,-40
2449,0,0,3,0,-3
2450,1,1,330,1661,1331
2451,1,0,43,0,-43
2452,0,0,42,0,-42
2453,1,1,623,1547,924
2454,1,1,96,10896,10800
2455,1,0,75,0,-75
2456,1,1,350,1315,965
2457,0,0,54,0,-54
2458,1,1,189,1428,1239
2459,1,1,76,2403,2327
2460,1,0,14,0,-14
2461,0,0,36,0,-36
2462,1,0,98,0,-98
2463,1,1,394,1404,1010
2464,0,0,129,0,-129
2465,1,1,664,1691,1027
2466,1,0,5,0,-5
2467,1,1,498,1237,739
2468,1,1,126,1263,1137
2469,1,0,159,0,-159
2470,1,1,384,1425,1041
2471,0,0,31,0,-31
2472,0,0,44,0,-44
2473,1,1,676,1369,693
2474,0,0,119,0,-119
2475,0,0,92,0,-92
2476,1,0,26,0,-26
2477,0,0,16,0,-16
2478,0,0,30,0,-30
2479,1,1,1556,1349,-207
2480,1,0,93,0,-93
2481,0,0,2,0,-2
2482,1,0,78,0,-78
2483,1,1,117,1486,1369
2484,1,0,40,0,-40
2485,0,0,1,0,-1
2486,1,1,78,2051,1973
2487,1,1,13,1424,1411
2488,1,0,5,0,-5
2489,0,0,6,0,-6
2490,1,0,71,0,-71
2491,1,1,1236,1420,184
2492,0,0,10,0,-10
2493,0,0,33,0,-33
2494,1,0,90,0,-90
2495,1,0,90,0,-90
2496,0,0,2,0,-2
2497,1,1,87,1525,1438
2498,0,0,1,0,-1
2499,1,1,1759,1739,-20
2500,0,0,33,0,-33
2501,1,1,116,1915,1799
2502,0,0,65,0,-65
2503,0,0,22,0,-22
2504,1,1,212,1230,1018
2505,0,0,12,0,-12
2506,1,0,26,0,-26
2507,0,0,5,0,-5
2508,1,0,78,0,-78
2509,1,1,88,1312,1224
2510,0,0,2,0,-2
2511,0,0,69,0,-69
2512,1,1,282,1235,953
2513,0,0,10,0,-10
2514,1,1,1108,1234,126
2515,0,0,140,0,-140
2516,0,0,77,0,-77
2517,1,0,27,0,-27
2518,1,0,121,0,-121
2519,0,0,2,0,-2
2520,1,1,1474,1327,-147
2521,1,1,580,1572,992
2522,0,0,1,0,-1
2523,1,0,4,0,-4
2524,0,0,22,0,-22
2525,1,1,183,1304,1121
2526,1,1,626,1717,1091
2527,1,1,36,1300,1264
2528,0,0,32,0,-32
2529,0,0,124,0,-124
2530,1,0,16,0,-16
2531,1,0,11,0,-11
2532,0,0,75,0,-75
2533,0,0,99,0,-99
2534,0,0,18,0,-18
2535,1,1,272,1908,1636
2536,0,0,76,0,-76
2537,0,0,21,0,-21
2538,0,0,40,0,-40
2539,0,0,51,0,-51
2540,0,0,50,0,-50
2541,1,0,72,0,-72
2542,0,0,20,0,-20
2543,1,1,564,1224,660
2544,0,0,204,0,-204
2545,1,0,48,0,-48
2546,1,0,21,0,-21
2547,1,0,60,0,-60
2548,1,0,57,0,-57
2549,0,0,66,0,-66
2550,1,0,274,0,-274
2551,1,1,660,1260,600
2552,1,0,55,0,-55
2553,1,1,805,2098,1293
2554,1,0,62,0,-62
2555,1,1,1785,1326,-459
2556,1,1,848,1870,1022
2557,1,0,121,0,-121
2558,0,0,27,0,-27
2559,0,0,39,0,-39
2560,1,1,935,1290,355
2561,1,1,1752,1516,-236
2562,1,0,4,0,-4
2563,0,0,25,0,-25
2564,1,1,365,1439,1074
2565,1,0,24,0,-24
2566,0,0,74,0,-74
2567,0,0,144,0,-144
2568,1,1,318,1278,960
2569,1,0,73,0,-73
2570,0,0,37,0,-37
2571,1,1,427,1340,913
2572,1,1,407,1364,957
2573,0,0,213,0,-213
2574,0,0,4,0,-4
2575,1,0,0,0,0
2576,0,0,37,0,-37
2577,1,1,1967,1346,-621
2578,0,0,5,0,-5
2579,1,1,261,1201,940
2580,0,0,19,0,-19
2581,0,0,0,0,0
2582,1,0,121,0,-121
2583,1,1,117,1310,1193
2584,1,1,272,1306,1034
2585,1,0,106,0,-106
2586,0,0,91,0,-91
2587,0,0,35,0,-35
2588,1,1,187,4366,4179
2589,1,1,512,1225,713
2590,1,0,20,0,-20
2591,1,0,8,0,-8
2592,1,1,455,1690,1235
2593,0,0,33,0,-33
2594,1,0,7,0,-7
2595,1,0,203,0,-203
2596,0,0,22,0,-22
2597,1,0,5,0,-5
2598,1,0,92,0,-92
2599,1,0,4,0,-4
2600,0,0,122,0,-122
2601,1,1,36,1319,1283
2602,0,0,145,0,-145
2603,0,0,27,0,-27
2604,1,1,238,4058,3820
2605,1,1,785,1383,598
2606,0,0,88,0,-88
2607,1,0,18,0,-18
2608,1,0,24,0,-24
2609,0,0,5,0,-5
2610,1,1,280,1318,1038
2611,0,0,71,0,-71
2612,1,1,505,1250,745
2613,0,0,50,0,-50
2614,1,1,485,1239,754
2615,1,0,70,0,-70
2616,0,0,7,0,-7
2617,0,0,48,0,-48
2618,0,0,33,0,-33
2619,1,1,829,1555,726
2620,0,0,159,0,-159
2621,0,0,116,0,-116
2622,1,0,63,0,-63
2623,1,1,236,2168,1932
2624,0,0,39,0,-39
2625,1,0,4,0,-4
2626,1,0,3,0,-3
2627,0,0,79,0,-79
2628,1,0,2,0,-2
2629,1,0,42,0,-42
2630,1,1,159,2009,1850
2631,1,1,529,2114,1585
2632,0,0,15,0,-15
2633,1,1,835,1490,655
2634,1,1,314,3855,3541
2635,0,0,46,0,-46
2636,0,0,46,0,-46
2637,1,1,510,1228,718
2638,1,1,620,1436,816
2639,0,0,68,0,-68
2640,1,1,862,1300,438
2641,0,0,326,0,-326
2642,1,1,994,1327,333
2643,0,0,25,0,-25
2644,0,0,17,0,-17
2645,1,1,398,1262,864
2646,1,0,45,0,-45
2647,0,0,19,0,-19
2648,0,0,183,0,-183
2649,0,0,0,0,0
2650,0,0,103,0,-103
2651,0,0,1,0,-1
2652,1,0,6,0,-6
2653,0,0,25,0,-25
2654,1,0,63,0,-63
2655,1,1,677,1815,1138
2656,1,0,64,0,-64
2657,1,1,572,1297,725
2658,0,0,14,0,-14
2659,1,0,0,0,0
2660,1,1,976,2068,1092
2661,0,0,33,0,-33
2662,1,1,88,1220,1132
2663,1,1,381,1693,1312
2664,1,0,11,0,-11
2665,1,1,327,1231,904
2666,1,1,607,1471,864
2667,1,0,5,0,-5
2668,0,0,31,0,-31
2669,0,0,20,0,-20
2670,1,0,18,0,-18
2671,1,0,25,0,-25
2672,1,1,728,1767,1039
2673,1,1,142,1435,1293
2674,0,0,50,0,-50
2675,1,0,80,0,-80
2676,1,1,411,1472,1061
2677,1,0,17,0,-17
2678,1,1,67,2059,1992
2679,0,0,17,0,-17
2680,1,1,81,1578,1497
2681,0,0,49,0,-49
2682,1,1,172,2239,2067
2683,0,0,57,0,-57
2684,1,0,81,0,-81
2685,1,1,1643,2004,361
2686,1,1,146,1673,1527
2687,1,1,450,1227,777
2688,1,0,22,0,-22
2689,0,0,5,0,-5
2690,0,0,6,0,-6
2691,1,0,8,0,-8
2692,1,1,233,2041,1808
2693,0,0,58,0,-58
2694,1,0,18,0,-18
2695,1,0,11,0,-11
2696,1,0,34,0,-34
2697,1,1,122,1866,1744
2698,0,0,67,0,-67
2699,0,0,3,0,-3
2700,0,0,9,0,-9
2701,1,1,42,1222,1180
2702,0,0,118,0,-118
2703,0,0,19,0,-19
2704,1,1,243,1424,1181
2705,0,0,41,0,-41
2706,1,1,166,1218,1052
2707,0,0,121,0,-121
2708,0,0,21,0,-21
2709,0,0,78,0,-78
2710,1,0,12,0,-12
2711,1,1,640,1263,623
2712,1,0,4,0,-4
2713,1,0,132,0,-132
2714,1,1,393,1241,848
2715,1,0,29,0,-29
2716,0,0,0,0,0
2717,0,0,55,0,-55
2718,0,0,66,0,-66
2719,0,0,67,0,-67
2720,1,1,616,3089,2473
2721,1,0,28,0,-28
2722,0,0,158,0,-158
2723,1,0,17,0,-17
2724,1,1,171,1508,1337
2725,1,0,1,0,-1
2726,0,0,21,0,-21
2727,1,0,3,0,-3
2728,1,0,42,0,-42
2729,0,0,33,0,-33
2730,1,0,71,0,-71
2731,1,0,5,0,-5
2732,0,0,156,0,-156
2733,0,0,26,0,-26
2734,1,1,310,1320,1010
2735,0,0,36,0,-36
2736,1,0,47,0,-47
2737,1,0,15,0,-15
2738,0,0,1,0,-1
2739,1,1,694,1458,764
2740,0,0,21,0,-21
2741,0,0,87,0,-87
2742,0,0,1,0,-1
2743,0,0,59,0,-59
2744,1,0,4,0,-4
2745,0,0,188,0,-188
2746,1,0,37,0,-37
2747,1,1,109,1303,1194
2748,0,0,52,0,-52
2749,1,1,927,1275,348
2750,1,0,179,0,-179
2751,0,0,20,0,-20
2752,1,1,141,4152,4011
2753,1,1,211,3481,3270
2754,1,0,61,0,-61
2755,1,1,832,1655,823
2756,1,0,10,0,-10
2757,0,0,21,0,-21
2758,0,0,3,0,-3
2759,0,0,23,0,-23
2760,1,0,12,0,-12
2761,1,0,132,0,-132
2762,1,1,60,1317,1257
2763,0,0,0,0,0
2764,1,1,61,3610,3549
2765,1,0,126,0,-126
2766,1,0,16,0,-16
2767,1,0,17,0,-17
2768,1,0,29,0,-29
2769,1,0,47,0,-47
2770,1,1,342,1378,1036
2771,0,0,29,0,-29
2772,0,0,24,0,-24
2773,1,0,23,0,-23
2774,1,0,68,0,-68
2775,0,0,150,0,-150
2776,1,1,952,1398,446
2777,0,0,8,0,-8
2778,1,0,16,0,-16
2779,0,0,82,0,-82
2780,1,1,239,1226,987
2781,1,0,10,0,-10
2782,0,0,21,0,-21
2783,1,0,15,0,-15
2784,1,1,285,1440,1155
2785,1,0,0,0,0
2786,1,1,501,1912,1411
2787,0,0,20,0,-20
2788,1,0,210,0,-210
2789,1,1,176,1231,1055
2790,0,0,10,0,-10
2791,1,1,37,2251,2214
2792,1,0,39,0,-39
2793,0,0,56,0,-56
2794,0,0,30,0,-30
2795,1,0,31,0,-31
2796,0,0,199,0,-199
2797,1,1,487,1285,798
2798,1,1,128,1935,1807
2799,1,0,87,0,-87
2800,0,0,3,0,-3
2801,1,0,52,0,-52
2802,1,1,142,1364,1222
2803,0,0,101,0,-101
2804,0,0,83,0,-83
2805,1,0,32,0,-32
2806,1,1,219,1563,1344
2807,1,0,1,0,-1
2808,1,0,25,0,-25
2809,0,0,45,0,-45
2810,1,1,1527,1667,140
2811,0,0,106,0,-106
2812,1,1,729,1242,513
2813,0,0,1,0,-1
2814,1,1,71,2006,1935
2815,1,1,901,1576,675
2816,0,0,51,0,-51
2817,1,1,713,1450,737
2818,1,1,595,1358,763
2819,0,0,14,0,-14
2820,0,0,39,0,-39
2821,1,1,496,4268,3772
2822,1,0,24,0,-24
2823,1,1,355,1253,898
2824,1,1,1081,1270,189
2825,0,0,6,0,-6
2826,0,0,26,0,-26
2827,1,1,640,1580,940
2828,1,1,249,1443,1194
2829,0,0,42,0,-42
2830,1,1,564,1249,685
2831,0,0,3,0,-3
2832,1,0,37,0,-37
2833,0,0,184,0,-184
2834,0,0,96,0,-96
2835,0,0,103,0,-103
2836,0,0,63,0,-63
2837,1,0,5,0,-5
2838,1,0,69,0,-69
2839,0,0,108,0,-108
2840,1,1,94,1262,1168
2841,0,0,61,0,-61
2842,1,0,21,0,-21
2843,1,0,18,0,-18
2844,0,0,1,0,-1
2845,0,0,23,0,-23
2846,0,0,7,0,-7
2847,0,0,34,0,-34
2848,1,0,1,0,-1
2849,0,0,75,0,-75
2850,0,0,42,0,-42
2851,0,0,38,0,-38
2852,1,1,1828,1223,-605
2853,0,0,102,0,-102
2854,0,0,22,0,-22
2855,0,0,19,0,-19
2856,0,0,27,0,-27
2857,1,1,466,1265,799
2858,1,1,88,1827,1739
2859,1,1,288,1968,1680
2860,0,0,124,0,-124
2861,1,0,51,0,-51
2862,0,0,45,0,-45
2863,0,0,0,0,0
2864,1,1,496,1399,903
2865,1,1,42,1392,1350
2866,1,1,530,1200,670
2867,0,0,103,0,-103
2868,1,0,11,0,-11
2869,1,1,1211,1231,20
2870,0,0,95,0,-95
2871,0,0,13,0,-13
2872,1,0,59,0,-59
2873,1,0,78,0,-78
2874,0,0,68,0,-68
2875,1,0,84,0,-84
2876,0,0,40,0,-40
2877,1,0,39,0,-39
2878,1,0,111,0,-111
2879,0,0,149,0,-149
2880,1,0,94,0,-94
2881,1,1,746,1272,526
2882,1,1,219,1553,1334
2883,1,1,118,1255,1137
2884,1,0,4,0,-4
2885,1,0,32,0,-32
2886,0,0,56,0,-56
2887,1,1,416,1379,963
2888,1,1,477,1304,827
2889,1,1,253,1299,1046
2890,1,1,1039,1215,176
2891,1,1,153,1611,1458
2892,1,0,26,0,-26
2893,1,0,68,0,-68
2894,0,0,5,0,-5
2895,0,0,102,0,-102
2896,0,0,126,0,-126
2897,1,0,48,0,-48
2898,0,0,31,0,-31
2899,1,1,557,1621,1064
2900,1,0,2,0,-2
2901,0,0,115,0,-115
2902,1,1,1052,1232,180
2903,0,0,54,0,-54
2904,0,0,35,0,-35
2905,0,0,98,0,-98
2906,1,1,1579,2387,808
2907,0,0,279,0,-279
2908,1,1,1500,1537,37
2909,0,0,47,0,-47
2910,1,0,7,0,-7
2911,0,0,2,0,-2
2912,0,0,29,0,-29
2913,1,0,5,0,-5
2914,1,1,529,1676,1147
2915,0,0,142,0,-142
2916,1,0,12,0,-12
2917,0,0,11,0,-11
2918,0,0,34,0,-34
2919,0,0,18,0,-18
2920,1,0,6,0,-6
2921,0,0,66,0,-66
2922,0,0,72,0,-72
2923,0,0,9,0,-9
2924,1,1,661,1378,717
2925,1,0,16,0,-16
2926,1,1,345,1362,1017
2927,0,0,4,0,-4
2928,0,0,25,0,-25
2929,1,1,491,1330,839
2930,0,0,45,0,-45
2931,0,0,57,0,-57
2932,1,1,670,1229,559
2933,1,1,468,1629,1161
2934,1,1,296,1310,1014
2935,1,0,31,0,-31
2936,0,0,24,0,-24
2937,0,0,32,0,-32
2938,0,0,19,0,-19
2939,1,1,106,1331,1225
2940,1,0,48,0,-48
2941,1,1,530,2825,2295
2942,1,0,47,0,-47
2943,1,1,300,1279,979
2944,1,0,18,0,-18
2945,1,1,34,1964,1930
2946,1,1,716,1291,575
2947,1,1,791,1623,832
2948,1,1,266,1428,1162
2949,0,0,7,0,-7
2950,1,0,116,0,-116
2951,1,0,95,0,-95
2952,1,0,95,0,-95
2953,0,0,67,0,-67
2954,1,0,61,0,-61
2955,0,0,163,0,-163
2956,1,1,404,1241,837
2957,0,0,10,0,-10
2958,1,1,1029,1397,368
2959,1,1,253,1630,1377
2960,1,0,4,0,-4
2961,1,0,7,0,-7
2962,0,0,64,0,-64
2963,1,1,511,1269,758
2964,0,0,16,0,-16
2965,1,0,4,0,-4
2966,0,0,13,0,-13
2967,1,1,206,1888,1682
2968,0,0,32,0,-32
2969,1,0,63,0,-63
2970,1,0,70,0,-70
2971,1,0,13,0,-13
2972,0,0,147,0,-147
2973,1,0,150,0,-150
2974,0,0,29,0,-29
2975,0,0,18,0,-18
2976,1,1,105,1242,1137
2977,1,0,34,0,-34
2978,0,0,60,0,-60
2979,1,1,666,1331,665
2980,1,1,413,1201,788
2981,1,0,33,0,-33
2982,0,0,68,0,-68
2983,0,0,4,0,-4
2984,1,1,1070,3150,2080
2985,1,0,43,0,-43
2986,1,0,21,0,-21
2987,1,1,622,1376,754
2988,0,0,7,0,-7
2989,0,0,58,0,-58
2990,0,0,2,0,-2
2991,1,1,1608,1227,-381
2992,1,1,597,1289,692
2993,0,0,16,0,-16
2994,0,0,30,0,-30
2995,0,0,68,0,-68
2996,0,0,15,0,-15
2997,0,0,4,0,-4
2998,1,0,31,0,-31
2999,0,0,59,0,-59
3000,0,0,27,0,-27
3001,0,0,26,0,-26
3002,1,1,240,1235,995
3003,0,0,3,0,-3
3004,0,0,9,0,-9
3005,1,0,12,0,-12
3006,1,1,490,1448,958
3007,1,0,0,0,0
3008,0,0,4,0,-4
3009,0,0,320,0,-320
3010,1,1,1564,1627,63
3011,0,0,85,0,-85
3012,1,0,19,0,-19
3013,1,0,2,0,-2
3014,0,0,20,0,-20
3015,0,0,22,0,-22
3016,0,0,3,0,-3
3017,1,0,3,0,-3
3018,0,0,63,0,-63
3019,1,1,94,1404,1310
3020,1,0,10,0,-10
3021,1,0,11,0,-11
3022,0,0,52,0,-52
3023,0,0,7,0,-7
3024,0,0,0,0,0
3025,0,0,0,0,0
3026,0,0,16,0,-16
3027,1,0,63,0,-63
3028,0,0,15,0,-15
3029,0,0,91,0,-91
3030,0,0,49,0,-49
3031,1,1,75,2917,2842
3032,1,1,452,1731,1279
3033,0,0,21,0,-21
3034,1,1,230,2430,2200
3035,1,0,20,0,-20
3036,1,1,121,1298,1177
3037,0,0,57,0,-57
3038,0,0,18,0,-18
3039,1,1,41,2418,2377
3040,0,0,90,0,-90
3041,0,0,14,0,-14
3042,1,0,79,0,-79
3043,1,0,19,0,-19
3044,1,1,1060,2267,1207
3045,0,0,7,0,-7
3046,0,0,11,0,-11
3047,0,0,18,0,-18
3048,1,0,52,0,-52
3049,1,1,228,1270,1042
3050,1,1,166,1389,1223
3051,1,0,0,0,0
3052,0,0,114,0,-114
3053,1,1,834,1758,924
3054,0,0,14,0,-14
3055,1,1,267,3247,2980
3056,1,1,101,1207,1106
3057,1,0,118,0,-118
3058,0,0,1,0,-1
3059,1,0,15,0,-15
3060,0,0,5,0,-5
3061,0,0,79,0,-79
3062,0,0,17,0,-17
3063,1,1,1063,1449,386
3064,1,0,111,0,-111
3065,0,0,43,0,-43
3066,1,1,153,4355,4202
3067,1,0,97,0,-97
3068,1,1,227,1376,1149
3069,1,1,873,1277,404
3070,0,0,6,0,-6
3071,1,1,699,1633,934
3072,1,1,188,1203,1015
3073,1,0,89,0,-89
3074,1,0,15,0,-15
3075,1,0,61,0,-61
3076,1,1,680,1259,579
3077,1,1,825,1226,401
3078,0,0,73,0,-73
3079,1,1,288,1586,1298
3080,0,0,120,0,-120
3081,0,0,65,0,-65
3082,0,0,34,0,-34
3083,1,0,67,0,-67
3084,0,0,32,0,-32
3085,0,0,9,0,-9
3086,0,0,6,0,-6
3087,1,0,13,0,-13
3088,0,0,29,0,-29
3089,0,0,1,0,-1
3090,1,1,2179,1288,-891
3091,1,1,126,1369,1243
3092,0,0,8,0,-8
3093,1,0,112,0,-112
3094,0,0,6,0,-6
3095,1,0,32,0,-32
3096,0,0,0,0,0
3097,0,0,73,0,-73
3098,1,1,91,1519,1428
3099,1,0,34,0,-34
3100,0,0,14,0,-14
3101,1,1,809,1251,442
3102,0,0,11,0,-11
3103,1,0,1,0,-1
3104,1,1,1091,1325,234
3105,0,0,30,0,-30
3106,0,0,89,0,-89
3107,0,0,0,0,0
3108,1,1,1561,1695,134
3109,1,0,5,0,-5
3110,1,1,626,1401,775
3111,1,1,47,1308,1261
3112,1,1,404,1577,1173
3113,1,1,230,1414,1184
3114,1,1,205,1406,1201
3115,0,0,100,0,-100
3116,1,0,53,0,-53
3117,1,0,67,0,-67
3118,0,0,45,0,-45
3119,1,0,3,0,-3
3120,1,1,323,1847,1524
3121,0,0,154,0,-154
3122,0,0,60,0,-60
3123,1,0,25,0,-25
3124,1,0,146,0,-146
3125,0,0,41,0,-41
3126,1,0,6,0,-6
3127,0,0,10,0,-10
3128,1,1,800,1484,684
3129,0,0,47,0,-47
3130,0,0,4,0,-4
3131,1,0,101,0,-101
3132,1,1,2240,2296,56
3133,1,1,812,1692,880
3134,1,1,804,1596,792
3135,1,0,43,0,-43
3136,1,0,287,0,-287
3137,1,1,945,1736,791
3138,0,0,136,0,-136
3139,1,0,42,0,-42
3140,0,0,61,0,-61
3141,1,1,60,1649,1589
3142,0,0,12,0,-12
3143,0,0,12,0,-12
3144,0,0,136,0,-136
3145,1,0,1,0,-1
3146,1,0,5,0,-5
3147,0,0,0,0,0
3148,1,0,53,0,-53
3149,1,0,236,0,-236
3150,0,0,4,0,-4
3151,0,0,51,0,-51
3152,0,0,35,0,-35
3153,1,1,1476,1801,325
3154,0,0,21,0,-21
3155,1,1,486,1217,731
3156,0,0,17,0,-17
3157,1,1,1392,1691,299
3158,1,0,115,0,-115
3159,1,0,32,0,-32
3160,1,0,14,0,-14
3161,1,1,521,2676,2155
3162,1,0,42,0,-42
3163,1,1,297,1391,1094
3164,1,1,118,1220,1102
3165,1,1,406,1936,1530
3166,1,1,128,2362,2234
3167,1,0,6,0,-6
3168,1,0,26,0,-26
3169,1,0,12,0,-12
3170,1,0,1,0,-1
3171,0,0,13,0,-13
3172,1,0,21,0,-21
3173,1,0,60,0,-60
3174,0,0,8,0,-8
3175,1,1,182,1281,1099
3176,0,0,49,0,-49
3177,1,0,25,0,-25
3178,0,0,137,0,-137
3179,1,1,351,1212,861
3180,1,1,147,1529,1382
3181,1,0,85,0,-85
3182,1,0,3,0,-3
3183,0,0,69,0,-69
3184,0,0,28,0,-28
3185,0,0,38,0,-38
3186,1,0,50,0,-50
3187,1,0,35,0,-35
3188,0,0,173,0,-173
3189,1,0,20,0,-20
3190,0,0,0,0,0
3191,1,0,29,0,-29
3192,1,0,77,0,-77
3193,0,0,44,0,-44
3194,1,1,271,3124,2853
3195,0,0,142,0,-142
3196,1,0,6,0,-6
3197,0,0,46,0,-46
3198,0,0,118,0,-118
3199,1,1,395,1394,999
3200,1,0,206,0,-206
3201,1,1,360,1315,955
3202,1,1,233,1291,1058
3203,1,0,14,0,-14
3204,0,0,118,0,-118
3205,0,0,88,0,-88
3206,1,0,10,0,-10
3207,0,0,13,0,-13
3208,1,1,671,1305,634
3209,0,0,16,0,-16
3210,1,1,714,1507,793
3211,1,1,955,1220,265
3212,0,0,70,0,-70
3213,0,0,129,0,-129
3214,1,0,79,0,-79
3215,0,0,45,0,-45
3216,1,0,75,0,-75
3217,0,0,1,0,-1
3218,0,0,3,0,-3
3219,1,1,655,1934,1279
3220,1,0,31,0,-31
3221,1,0,52,0,-52
3222,1,0,16,0,-16
3223,1,1,320,1547,1227
3224,1,1,301,1214,913
3225,1,0,45,0,-45
3226,0,0,82,0,-82
3227,0,0,25,0,-25
3228,1,0,2,0,-2
3229,0,0,100,0,-100
3230,1,0,31,0,-31
3231,1,1,419,1682,1263
3232,1,0,21,0,-21
3233,1,0,6,0,-6
3234,1,0,35,0,-35
3235,0,0,162,0,-162
3236,1,0,3,0,-3
3237,0,0,10,0,-10
3238,1,1,109,1510,1401
3239,0,0,253,0,-253
3240,1,1,153,1350,1197
3241,1,1,850,1218,368
3242,0,0,102,0,-102
3243,0,0,63,0,-63
3244,1,0,39,0,-39
3245,0,0,102,0,-102
3246,1,1,102,1363,1261
3247,0,0,2,0,-2
3248,1,1,868,1259,391
3249,1,0,30,0,-30
3250,1,0,48,0,-48
3251,1,0,38,0,-38
3252,1,0,43,0,-43
3253,0,0,66,0,-66
3254,1,1,1572,1213,-359
3255,0,0,30,0,-30
3256,1,1,243,1369,1126
3257,1,0,69,0,-69
3258,1,1,461,1280,819
3259,1,0,79,0,-79
3260,0,0,82,0,-82
3261,1,1,841,1268,427
3262,0,0,7,0,-7
3263,1,0,7,0,-7
3264,1,1,334,1423,1089
3265,0,0,122,0,-122
3266,1,0,23,0,-23
3267,0,0,1,0,-1
3268,1,0,12,0,-12
3269,0,0,48,0,-48
3270,0,0,88,0,-88
3271,0,0,35,0,-35
3272,1,1,1280,1436,156
3273,1,0,76,0,-76
3274,0,0,78,0,-78
3275,0,0,0,0,0
3276,0,0,62,0,-62
3277,0,0,176,0,-176
3278,1,0,26,0,-26
3279,1,0,24,0,-24
3280,1,0,13,0,-13
3281,1,1,429,1525,1096
3282,1,1,87,1259,1172
3283,1,1,372,1270,898
3284,0,0,0,0,0
3285,0,0,8,0,-8
3286,1,0,10,0,-10
3287,1,1,44,1474,1430
3288,1,1,1793,1562,-231
3289,0,0,68,0,-68
3290,0,0,27,0,-27
3291,1,1,515,1336,821
3292,1,1,733,2486,1753
3293,1,0,47,0,-47
3294,1,0,41,0,-41
3295,0,0,19,0,-19
3296,1,0,94,0,-94
3297,1,1,489,1465,976
3298,1,1,254,1949,1695
3299,0,0,49,0,-49
3300,0,0,0,0,0
3301,1,0,6,0,-6
3302,1,0,7,0,-7
3303,0,0,21,0,-21
3304,1,1,867,3282,2415
3305,0,0,26,0,-26
3306,0,0,29,0,-29
3307,1,1,531,1508,977
3308,1,1,191,1209,1018
3309,1,0,84,0,-84
3310,0,0,118,0,-118
3311,1,0,40,0,-40
3312,1,1,1455,1483,28
3313,1,1,856,1488,632
3314,0,0,26,0,-26
3315,0,0,77,0,-77
3316,1,1,531,1853,1322
3317,1,1,278,1745,1467
3318,0,0,38,0,-38
3319,0,0,36,0,-36
3320,1,1,201,1235,1034
3321,1,1,101,1460,1359
3322,1,1,526,1473,947
3323,1,0,36,0,-36
3324,0,0,9,0,-9
3325,0,0,31,0,-31
3326,1,1,283,1213,930
3327,1,1,1057,1311,254
3328,1,0,35,0,-35
3329,0,0,2,0,-2
3330,0,0,56,0,-56
3331,0,0,18,0,-18
3332,0,0,1,0,-1
3333,0,0,17,0,-17
3334,1,1,416,1723,1307
3335,1,0,78,0,-78
3336,1,1,84,1721,1637
3337,1,1,608,1310,702
3338,1,1,748,1772,1024
3339,0,0,11,0,-11
3340,0,0,29,0,-29
3341,0,0,65,0,-65
3342,0,0,32,0,-32
3343,1,1,1106,1362,256
3344,1,1,125,1958,1833
3345,1,1,1250,2298,1048
3346,1,0,1,0,-1
3347,1,1,706,1498,792
3348,0,0,5,0,-5
3349,0,0,8,0,-8
3350,1,1,2232,1665,-567
3351,1,0,157,0,-157
3352,1,1,248,1390,1142
3353,0,0,15,0,-15
3354,0,0,160,0,-160
3355,1,0,26,0,-26
3356,1,1,933,1584,651
3357,0,0,32,0,-32
3358,1,1,291,1399,1108
3359,0,0,6,0,-6
3360,1,1,972,1366,394
3361,0,0,67,0,-67
3362,0,0,33,0,-33
3363,1,1,1530,1929,399
3364,1,0,56,0,-56
3365,0,0,78,0,-78
3366,0,0,208,0,-208
3367,0,0,78,0,-78
3368,1,1,875,1323,448
3369,1,1,547,1305,758
3370,1,0,169,0,-169
3371,0,0,10,0,-10
3372,0,0,15,0,-15
3373,1,0,29,0,-29
3374,1,0,10,0,-10
3375,1,0,31,0,-31
3376,1,0,25,0,-25
3377,1,1,234,1777,1543
3378,1,1,702,1318,616
3379,0,0,43,0,-43
3380,1,1,457,2224,1767
3381,0,0,73,0,-73
3382,1,0,296,0,-296
3383,1,0,18,0,-18
3384,1,0,32,0,-32
3385,1,1,1320,2121,801
3386,0,0,16,0,-16
3387,0,0,8,0,-8
3388,1,0,41,0,-41
3389,1,0,35,0,-35
3390,0,0,23,0,-23
3391,1,1,242,1266,1024
3392,0,0,94,0,-94
3393,0,0,6,0,-6
3394,1,0,6,0,-6
3395,1,1,273,1868,1595
3396,1,1,594,1368,774
3397,1,0,113,0,-113
3398,0,0,7,0,-7
3399,1,0,35,0,-35
3400,0,0,92,0,-92
3401,0,0,41,0,-41
3402,1,1,548,1489,941
3403,0,0,36,0,-36
3404,1,0,4,0,-4
3405,0,0,6,0,-6
3406,1,0,133,0,-133
3407,1,1,473,1403,930
3408,1,0,92,0,-92
3409,0,0,3,0,-3
3410,0,0,150,0,-150
3411,1,1,588,1700,1112
3412,1,1,451,2391,1940
3413,0,0,7,0,-7
3414,1,1,47,2008,1961
3415,1,0,76,0,-76
3416,0,0,5,0,-5
3417,1,1,153,1214,1061
3418,1,1,221,1472,1251
3419,0,0,12,0,-12
3420,0,0,65,0,-65
3421,1,1,319,1941,1622
3422,1,1,103,1622,1519
3423,0,0,26,0,-26
3424,1,0,33,0,-33
3425,1,1,459,5085,4626
3426,1,0,45,0,-45
3427,1,1,307,1257,950
3428,1,0,28,0,-28
3429,1,1,1463,1797,334
3430,1,1,489,1263,774
3431,1,1,282,1437,1155
3432,0,0,15,0,-15
3433,0,0,8,0,-8
3434,1,1,58,1249,1191
3435,1,0,23,0,-23
3436,1,1,85,1259,1174
3437,0,0,81,0,-81
3438,0,0,1,0,-1
3439,0,0,13,0,-13
3440,1,1,899,1368,469
3441,1,1,996,1588,592
3442,1,0,16,0,-16
3443,0,0,15,0,-15
3444,1,1,602,1219,617
3445,0,0,0,0,0
3446,1,0,57,0,-57
3447,1,1,375,1591,1216
3448,0,0,0,0,0
3449,1,1,2055,1323,-732
3450,0,0,104,0,-104
3451,1,1,871,1812,941
3452,0,0,78,0,-78
3453,1,1,986,1612,626
3454,0,0,21,0,-21
3455,1,0,48,0,-48
3456,0,0,64,0,-64
3457,1,0,44,0,-44
3458,1,0,4,0,-4
3459,0,0,42,0,-42
3460,0,0,53,0,-53
3461,1,1,172,1504,1332
3462,1,1,1058,1657,599
3463,1,1,435,1391,956
3464,1,0,33,0,-33
3465,0,0,33,0,-33
3466,0,0,31,0,-31
3467,1,1,144,2437,2293
3468,1,1,102,1485,1383
3469,1,1,582,1305,723
3470,1,0,40,0,-40
3471,1,1,2811,1992,-819
3472,1,0,79,0,-79
3473,1,0,87,0,-87
3474,1,0,21,0,-21
3475,0,0,20,0,-20
3476,0,0,29,0,-29
3477,0,0,19,0,-19
3478,1,0,5,0,-5
3479,1,0,31,0,-31
3480,1,1,491,1212,721
3481,0,0,0,0,0
3482,0,0,21,0,-21
3483,0,0,92,0,-92
3484,0,0,2,0,-2
3485,0,0,12,0,-12
3486,1,0,4,0,-4
3487,1,1,332,1230,898
3488,0,0,15,0,-15
3489,1,1,103,1375,1272
3490,1,0,6,0,-6
3491,1,0,36,0,-36
3492,0,0,1,0,-1
3493,0,0,0,0,0
3494,1,1,645,1293,648
3495,1,1,160,1274,1114
3496,1,1,449,2274,1825
3497,1,0,17,0,-17
3498,1,0,21,0,-21
3499,1,1,34,1306,1272
3500,1,0,38,0,-38
3501,1,0,21,0,-21
3502,0,0,5,0,-5
3503,1,0,21,0,-21
3504,1,1,428,1348,920
3505,1,0,13,0,-13
3506,1,1,905,1584,679
3507,0,0,59,0,-59
3508,1,0,21,0,-21
3509,1,1,1584,1352,-232
3510,0,0,46,0,-46
3511,1,0,14,0,-14
3512,1,0,3,0,-3
3513,1,1,773,1921,1148
3514,0,0,20,0,-20
3515,1,1,1620,2516,896
3516,0,0,33,0,-33
3517,1,1,464,1215,751
3518,1,1,166,1279,1113
3519,1,0,103,0,-103
3520,0,0,80,0,-80
3521,0,0,90,0,-90
3522,1,1,790,1255,465
3523,1,0,17,0,-17
3524,1,0,14,0,-14
3525,0,0,37,0,-37
3526,1,0,11,0,-11
3527,1,0,8,0,-8
3528,1,0,14,0,-14
3529,0,0,144,0,-144
3530,1,0,84,0,-84
3531,0,0,34,0,-34
3532,0,0,62,0,-62
3533,1,1,123,1853,1730
3534,1,1,833,3697,2864
3535,1,1,184,1209,1025
3536,1,1,969,1303,334
3537,1,1,298,2866,2568
3538,1,0,30,0,-30
3539,1,0,23,0,-23
3540,1,1,367,1223,856
3541,0,0,86,0,-86
3542,0,0,16,0,-16
3543,0,0,41,0,-41
3544,0,0,16,0,-16
3545,1,1,406,1395,989
3546,0,0,58,0,-58
3547,0,0,122,0,-122
3548,0,0,107,0,-107
3549,1,0,20,0,-20
3550,0,0,43,0,-43
3551,0,0,8,0,-8
3552,0,0,76,0,-76
3553,1,0,203,0,-203
3554,1,0,43,0,-43
3555,1,1,276,3683,3407
3556,1,1,189,1714,1525
3557,1,1,303,1716,1413
3558,0,0,51,0,-51
3559,0,0,24,0,-24
3560,1,1,351,1236,885
3561,1,1,501,1263,762
3562,1,1,1380,2016,636
3563,0,0,6,0,-6
3564,1,0,57,0,-57
3565,1,1,643,1600,957
3566,1,0,77,0,-77
3567,1,1,297,1940,1643
3568,0,0,53,0,-53
3569,0,0,54,0,-54
3570,1,0,8,0,-8
3571,1,1,323,1300,977
3572,0,0,20,0,-20
3573,1,0,94,0,-94
3574,1,1,161,1362,1201
3575,0,0,27,0,-27
3576,0,0,39,0,-39
3577,1,0,10,0,-10
3578,0,0,0,0,0
3579,1,0,92,0,-92
3580,1,0,40,0,-40
3581,1,0,15,0,-15
3582,1,0,140,0,-140
3583,1,1,744,1298,554
3584,1,0,29,0,-29
3585,0,0,176,0,-176
3586,1,0,9,0,-9
3587,1,1,225,1416,1191
3588,0,0,29,0,-29
3589,1,0,8,0,-8
3590,0,0,174,0,-174
3591,1,0,79,0,-79
3592,1,1,341,1708,1367
3593,1,1,761,1477,716
3594,1,0,167,0,-167
3595,1,0,1,0,-1
3596,1,0,97,0,-97
3597,1,0,0,0,0
3598,1,0,63,0,-63
3599,0,0,13,0,-13
3600,0,0,123,0,-123
3601,0,0,105,0,-105
3602,1,0,12,0,-12
3603,1,1,41,1200,1159
3604,0,0,34,0,-34
3605,0,0,31,0,-31
3606,0,0,106,0,-106
3607,0,0,154,0,-154
3608,1,1,268,2664,2396
3609,1,0,319,0,-319
3610,0,0,53,0,-53
3611,1,1,100,1218,1118
3612,0,0,37,0,-37
3613,0,0,54,0,-54
3614,0,0,52,0,-52
3615,1,0,45,0,-45
3616,1,0,61,0,-61
3617,1,0,102,0,-102
3618,0,0,16,0,-16
3619,1,0,18,0,-18
3620,1,1,185,1222,1037
3621,1,1,942,1431,489
3622,1,0,117,0,-117
3623,1,0,135,0,-135
3624,1,0,41,0,-41
3625,0,0,3,0,-3
3626,1,0,21,0,-21
3627,1,1,186,1216,1030
3628,1,1,849,1622,773
3629,1,0,69,0,-69
3630,0,0,83,0,-83
3631,1,0,12,0,-12
3632,1,0,135,0,-135
3633,0,0,20,0,-20
3634,1,1,1338,1361,23
3635,1,1,452,1434,982
3636,1,0,78,0,-78
3637,1,0,111,0,-111
3638,0,0,11,0,-11
3639,1,1,106,1334,1228
3640,1,1,444,1236,792
3641,0,0,49,0,-49
3642,0,0,35,0,-35
3643,0,0,17,0,-17
3644,0,0,10,0,-10
3645,1,1,147,1279,1132
3646,1,1,183,1234,1051
3647,0,0,196,0,-196
3648,1,0,19,0,-19
3649,0,0,164,0,-164
3650,1,0,0,0,0
3651,0,0,186,0,-186
3652,1,0,110,0,-110
3653,1,0,44,0,-44
3654,1,1,494,1648,1154
3655,0,0,4,0,-4
3656,1,1,776,1228,452
3657,0,0,62,0,-62
3658,0,0,130,0,-130
3659,1,1,265,2239,1974
3660,1,0,64,0,-64
3661,1,1,1642,2137,495
3662,1,1,739,1313,574
3663,1,0,260,0,-260
3664,1,0,6,0,-6
3665,1,0,15,0,-15
3666,0,0,19,0,-19
3667,1,1,422,1407,985
3668,1,1,409,1750,1341
3669,1,0,7,0,-7
3670,1,1,546,1387,841
3671,0,0,45,0,-45
3672,1,1,325,1352,1027
3673,0,0,37,0,-37
3674,1,1,130,1556,1426
3675,1,1,909,1210,301
3676,0,0,31,0,-31
3677,1,1,1086,1265,179
3678,1,1,65,7422,7357
3679,0,0,20,0,-20
3680,1,0,206,0,-206
3681,1,0,10,0,-10
3682,1,1,95,1378,1283
3683,0,0,16,0,-16
3684,0,0,30,0,-30
3685,1,0,16,0,-16
3686,1,0,76,0,-76
3687,0,0,49,0,-49
3688,0,0,40,0,-40
3689,0,0,59,0,-59
3690,0,0,14,0,-14
3691,1,0,16,0,-16
3692,1,1,546,1599,1053
3693,0,0,16,0,-16
3694,1,1,519,2614,2095
3695,0,0,38,0,-38
3696,0,0,59,0,-59
3697,1,0,212,0,-212
3698,1,1,2067,1592,-475
3699,0,0,112,0,-112
3700,0,0,15,0,-15
3701,1,0,171,0,-171
3702,1,0,2,0,-2
3703,1,1,717,1592,875
3704,1,1,528,1284,756
3705,1,1,115,1221,1106
3706,1,0,4,0,-4
3707,1,0,124,0,-124
3708,0,0,25,0,-25
3709,1,0,9,0,-9
3710,0,0,57,0,-57
3711,0,0,191,0,-191
3712,0,0,63,0,-63
3713,1,1,4,1254,1250
3714,1,1,365,1254,889
3715,0,0,15,0,-15
3716,0,0,26,0,-26
3717,0,0,53,0,-53
3718,0,0,57,0,-57
3719,0,0,3,0,-3
3720,0,0,129,0,-129
3721,1,0,23,0,-23
3722,0,0,63,0,-63
3723,0,0,100,0,-100
3724,1,1,44,1369,1325
3725,1,0,60,0,-60
3726,1,1,1044,1478,434
3727,1,1,216,2081,1865
3728,0,0,6,0,-6
3729,1,0,135,0,-135
3730,1,0,68,0,-68
3731,1,1,547,1555,1008
3732,1,1,420,1217,797
3733,1,1,249,1390,1141
3734,1,0,12,0,-12
3735,0,0,3,0,-3
3736,0,0,55,0,-55
3737,0,0,26,0,-26
3738,0,0,9,0,-9
3739,1,0,14,0,-14
3740,0,0,21,0,-21
3741,0,0,37,0,-37
3742,1,1,115,1429,1314
3743,1,0,15,0,-15
3744,1,0,8,0,-8
3745,1,1,792,2097,1305
3746,1,0,5,0,-5
3747,1,1,958,1452,494
3748,0,0,14,0,-14
3749,1,1,377,1467,1090
3750,0,0,176,0,-176
3751,1,1,70,1313,1243
3752,0,0,82,0,-82
3753,0,0,145,0,-145
3754,1,1,275,2769,2494
3755,0,0,188,0,-188
3756,0,0,6,0,-6
3757,0,0,30,0,-30
3758,1,1,33,1564,1531
3759,0,0,16,0,-16
3760,1,1,272,1201,929
3761,0,0,3,0,-3
3762,0,0,20,0,-20
3763,0,0,7,0,-7
3764,1,1,263,1978,1715
3765,1,1,135,1719,1584
3766,1,0,30,0,-30
3767,1,1,791,2363,1572
3768,1,0,39,0,-39
3769,0,0,70,0,-70
3770,1,1,488,1291,803
3771,1,0,2,0,-2
3772,1,0,90,0,-90
3773,0,0,13,0,-13
3774,0,0,17,0,-17
3775,1,1,424,1289,865
3776,1,0,1,0,-1
3777,1,1,137,2925,2788
3778,0,0,44,0,-44
3779,1,0,61,0,-61
3780,1,0,43,0,-43
3781,1,1,83,1531,1448
3782,1,0,26,0,-26
3783,1,1,297,1408,1111
3784,1,1,302,1610,1308
3785,1,0,23,0,-23
3786,1,1,580,1293,713
3787,1,1,17,1304,1287
3788,1,1,766,1368,602
3789,0,0,4,0,-4
3790,1,1,1058,1260,202
3791,0,0,71,0,-71
3792,1,1,698,1998,1300
3793,1,0,44,0,-44
3794,0,0,99,0,-99
3795,1,0,6,0,-6
3796,0,0,7,0,-7
3797,1,0,17,0,-17
3798,1,0,96,0,-96
3799,0,0,64,0,-64
3800,1,0,215,0,-215
3801,0,0,137,0,-137
3802,1,0,11,0,-11
3803,0,0,13,0,-13
3804,1,0,76,0,-76
3805,0,0,76,0,-76
3806,1,1,1152,1807,655
3807,1,0,95,0,-95
3808,0,0,87,0,-87
3809,0,0,41,0,-41
3810,1,1,122,1476,1354
3811,0,0,64,0,-64
3812,1,0,8,0,-8
3813,1,0,33,0,-33
3814,1,0,50,0,-50
3815,1,0,51,0,-51
3816,1,1,27,2063,2036
3817,0,0,36,0,-36
3818,1,1,1259,1257,-2
3819,1,0,21,0,-21
3820,1,1,1251,1735,484
3821,1,1,383,1302,919
3822,1,1,81,1333,1252
3823,0,0,36,0,-36
3824,1,0,126,0,-126
3825,1,1,173,1308,1135
3826,0,0,50,0,-50
3827,1,1,152,1563,1411
3828,1,0,5,0,-5
3829,1,0,62,0,-62
3830,0,0,108,0,-108
3831,0,0,97,0,-97
3832,1,1,164,1310,1146
3833,1,1,576,1201,625
3834,1,1,135,1255,1120
3835,1,0,2,0,-2
3836,1,0,163,0,-163
3837,1,1,315,1889,1574
3838,1,1,513,1261,748
3839,0,0,41,0,-41
3840,1,1,222,1260,1038
3841,1,1,1115,2326,1211
3842,1,1,470,1374,904
3843,0,0,0,0,0
3844,1,0,21,0,-21
3845,0,0,7,0,-7
3846,1,0,1,0,-1
3847,0,0,43,0,-43
3848,0,0,7,0,-7
3849,1,1,931,1308,377
3850,1,1,280,1392,1112
3851,1,0,123,0,-123
3852,1,0,69,0,-69
3853,1,1,1272,1241,-31
3854,1,1,756,1571,815
3855,0,0,32,0,-32
3856,1,1,1291,1290,-1
3857,1,1,91,1569,1478
3858,1,0,13,0,-13
3859,1,0,66,0,-66
3860,0,0,14,0,-14
3861,1,1,355,1632,1277
3862,0,0,100,0,-100
3863,1,0,22,0,-22
3864,0,0,203,0,-203
3865,1,0,91,0,-91
3866,0,0,52,0,-52
3867,0,0,43,0,-43
3868,1,1,1530,2327,797
3869,0,0,9,0,-9
3870,1,0,47,0,-47
3871,1,1,19,1288,1269
3872,1,1,117,1612,1495
3873,1,1,216,1261,1045
3874,0,0,24,0,-24
3875,1,1,319,1534,1215
3876,1,0,0,0,0
3877,1,0,31,0,-31
3878,1,1,590,2191,1601
3879,1,1,594,3555,2961
3880,0,0,5,0,-5
3881,1,0,24,0,-24
3882,1,1,1931,1204,-727
3883,1,0,12,0,-12
3884,1,0,80,0,-80
3885,1,1,356,2221,1865
3886,1,1,195,1389,1194
3887,1,0,16,0,-16
3888,0,0,3,0,-3
3889,1,1,121,3280,3159
3890,1,0,15,0,-15
3891,1,0,2,0,-2
3892,1,0,17,0,-17
3893,0,0,53,0,-53
3894,1,0,43,0,-43
3895,0,0,46,0,-46
3896,1,0,9,0,-9
3897,0,0,150,0,-150
3898,0,0,9,0,-9
3899,0,0,10,0,-10
3900,0,0,7,0,-7
3901,1,1,814,2762,1948
3902,1,0,89,0,-89
3903,0,0,27,0,-27
3904,1,0,87,0,-87
3905,0,0,19,0,-19
3906,1,0,8,0,-8
3907,1,1,661,1208,547
3908,0,0,23,0,-23
3909,1,1,130,1264,1134
3910,0,0,14,0,-14
3911,1,0,48,0,-48
3912,1,0,32,0,-32
3913,1,1,927,1584,657
3914,1,0,16,0,-16
3915,0,0,2,0,-2
3916,1,1,69,1413,1344
3917,1,1,286,1335,1049
3918,1,1,269,1423,1154
3919,0,0,71,0,-71
3920,1,0,38,0,-38
3921,1,1,691,1214,523
3922,1,0,7,0,-7
3923,1,1,1261,1243,-18
3924,0,0,85,0,-85
3925,1,1,78,1350,1272
3926,0,0,62,0,-62
3927,1,1,513,1504,991
3928,0,0,37,0,-37
3929,1,0,8,0,-8
3930,1,0,77,0,-77
3931,0,0,37,0,-37
3932,0,0,3,0,-3
3933,1,0,57,0,-57
3934,1,1,1385,2065,680
3935,1,0,18,0,-18
3936,0,0,10,0,-10
3937,0,0,129,0,-129
3938,1,1,1159,1235,76
3939,1,1,471,2485,2014
3940,1,1,138,1682,1544
3941,1,0,67,0,-67
3942,1,1,550,1408,858
3943,0,0,109,0,-109
3944,0,0,63,0,-63
3945,0,0,3,0,-3
3946,0,0,17,0,-17
3947,0,0,28,0,-28
3948,1,1,306,2433,2127
3949,1,1,107,1355,1248
3950,1,0,38,0,-38
3951,0,0,4,0,-4
3952,1,0,221,0,-221
3953,0,0,6,0,-6
3954,0,0,6,0,-6
3955,0,0,69,0,-69
3956,0,0,55,0,-55
3957,1,1,282,1750,1468
3958,0,0,52,0,-52
3959,1,1,88,1302,1214
3960,0,0,79,0,-79
3961,0,0,30,0,-30
3962,1,1,1373,1386,13
3963,1,0,8,0,-8
3964,0,0,10,0,-10
3965,0,0,84,0,-84
3966,1,1,507,1327,820
3967,0,0,46,0,-46
3968,1,0,78,0,-78
3969,1,0,23,0,-23
3970,0,0,109,0,-109
3971,0,0,12,0,-12
3972,1,0,68,0,-68
3973,1,1,1131,2006,875
3974,1,0,19,0,-19
3975,1,1,303,2020,1717
3976,0,0,65,0,-65
3977,1,0,7,0,-7
3978,1,1,384,1231,847
3979,1,0,5,0,-5
3980,0,0,11,0,-11
3981,0,0,27,0,-27
3982,0,0,134,0,-134
3983,0,0,18,0,-18
3984,1,1,445,1222,777
3985,0,0,33,0,-33
3986,0,0,49,0,-49
3987,0,0,17,0,-17
3988,0,0,25,0,-25
3989,1,0,6,0,-6
3990,1,0,39,0,-39
3991,0,0,41,0,-41
3992,1,1,51,1243,1192
3993,1,0,38,0,-38
3994,1,0,18,0,-18
3995,1,1,551,1331,780
3996,1,1,459,1577,1118
3997,0,0,6,0,-6
3998,0,0,11,0,-11
3999,1,0,60,0,-60
4000,1,0,7,0,-7
4001,1,1,412,1844,1432
4002,0,0,196,0,-196
4003,1,1,306,1317,1011
4004,0,0,68,0,-68
4005,1,0,26,0,-26
4006,1,1,56,1331,1275
4007,0,0,13,0,-13
4008,1,1,1164,1288,124
4009,1,1,73,1425,1352
4010,1,0,50,0,-50
4011,1,1,90,1489,1399
4012,0,0,9,0,-9
4013,1,0,51,0,-51
4014,0,0,26,0,-26
4015,0,0,12,0,-12
4016,1,1,148,1264,1116
4017,1,1,105,1214,1109
4018,1,0,41,0,-41
4019,0,0,28,0,-28
4020,0,0,4,0,-4
4021,1,0,41,0,-41
4022,1,1,1291,1895,604
4023,0,0,10,0,-10
4024,1,0,18,0,-18
4025,1,1,322,1473,1151
4026,1,1,270,1219,949
4027,0,0,45,0,-45
4028,0,0,71,0,-71
4029,1,1,353,1423,1070
4030,1,1,207,1679,1472
4031,0,0,70,0,-70
4032,1,1,178,1414,1236
4033,1,1,848,1323,475
4034,0,0,5,0,-5
4035,0,0,47,0,-47
4036,0,0,107,0,-107
4037,1,0,128,0,-128
4038,0,0,285,0,-285
4039,1,0,33,0,-33
4040,1,1,402,1363,961
4041,1,1,123,1237,1114
4042,0,0,62,0,-62
4043,0,0,18,0,-18
4044,1,1,779,1755,976
4045,0,0,27,0,-27
4046,1,0,4,0,-4
4047,0,0,68,0,-68
4048,1,0,45,0,-45
4049,0,0,20,0,-20
4050,1,1,197,1343,1146
4051,1,1,316,2809,2493
4052,1,0,46,0,-46
4053,0,0,81,0,-81
4054,0,0,10,0,-10
4055,1,1,172,1663,1491
4056,1,0,45,0,-45
4057,0,0,16,0,-16
4058,0,0,33,0,-33
4059,0,0,70,0,-70
4060,1,1,682,1797,1115
4061,1,1,534,1221,687
4062,1,1,51,1240,1189
4063,0,0,49,0,-49
4064,1,0,107,0,-107
4065,1,0,42,0,-42
4066,0,0,281,0,-281
4067,1,0,5,0,-5
4068,0,0,2,0,-2
4069,0,0,9,0,-9
4070,1,0,9,0,-9
4071,1,1,234,1290,1056
4072,1,0,66,0,-66
4073,1,0,56,0,-56
4074,1,1,918,1502,584
4075,1,0,13,0,-13
4076,0,0,143,0,-143
4077,0,0,16,0,-16
4078,0,0,13,0,-13
4079,0,0,8,0,-8
4080,0,0,23,0,-23
4081,0,0,34,0,-34
4082,0,0,7,0,-7
4083,1,1,4,1315,1311
4084,0,0,74,0,-74
4085,1,1,313,1548,1235
4086,0,0,0,0,0
4087,0,0,56,0,-56
4088,0,0,40,0,-40
4089,0,0,66,0,-66
4090,1,0,1,0,-1
4091,0,0,6,0,-6
4092,0,0,77,0,-77
4093,0,0,55,0,-55
4094,1,0,37,0,-37
4095,1,0,212,0,-212
4096,1,0,24,0,-24
4097,1,0,28,0,-28
4098,0,0,141,0,-141
4099,0,0,2,0,-2
4100,1,0,60,0,-60
4101,0,0,4,0,-4
4102,1,0,7,0,-7
4103,1,1,114,1412,1298
4104,1,0,103,0,-103
4105,0,0,62,0,-62
4106,1,0,153,0,-153
4107,1,1,423,1945,1522
4108,1,1,92,1534,1442
4109,1,0,179,0,-179
4110,1,0,4,0,-4
4111,0,0,98,0,-98
4112,1,1,92,1787,1695
4113,1,0,32,0,-32
4114,1,1,1047,1751,704
4115,0,0,17,0,-17
4116,0,0,129,0,-129
4117,1,0,26,0,-26
4118,0,0,28,0,-28
4119,0,0,63,0,-63
4120,0,0,16,0,-16
4121,1,0,58,0,-58
4122,0,0,52,0,-52
4123,1,0,122,0,-122
4124,1,1,275,1427,1152
4125,0,0,2,0,-2
4126,0,0,33,0,-33
4127,1,0,3,0,-3
4128,0,0,20,0,-20
4129,1,1,354,1853,1499
4130,1,0,74,0,-74
4131,1,0,83,0,-83
4132,1,0,76,0,-76
4133,1,1,124,1301,1177
4134,1,1,614,1333,719
4135,1,0,35,0,-35
4136,0,0,70,0,-70
4137,0,0,34,0,-34
4138,0,0,24,0,-24
4139,1,1,174,2019,1845
4140,1,1,231,1201,970
4141,0,0,7,0,-7
4142,1,1,1111,1366,255
4143,1,1,33,1235,1202
4144,0,0,58,0,-58
4145,0,0,155,0,-155
4146,1,1,659,1409,750
4147,1,0,91,0,-91
4148,0,0,13,0,-13
4149,1,1,314,1206,892
4150,0,0,58,0,-58
4151,0,0,1,0,-1
4152,0,0,6,0,-6
4153,0,0,22,0,-22
4154,1,1,102,1367,1265
4155,0,0,5,0,-5
4156,1,1,1457,4275,2818
4157,0,0,16,0,-16
4158,0,0,53,0,-53
4159,0,0,20,0,-20
4160,0,0,62,0,-62
4161,0,0,12,0,-12
4162,1,0,57,0,-57
4163,1,1,511,1200,689
4164,0,0,42,0,-42
4165,1,0,12,0,-12
4166,1,0,76,0,-76
4167,1,1,704,1440,736
4168,1,1,1107,1682,575
4169,0,0,36,0,-36
4170,1,0,68,0,-68
4171,1,1,102,1204,1102
4172,1,1,1128,1886,758
4173,1,1,2035,1381,-654
4174,1,1,264,1224,960
4175,1,1,583,1305,722
4176,0,0,169,0,-169
4177,0,0,4,0,-4
4178,1,0,160,0,-160
4179,0,0,83,0,-83
4180,0,0,11,0,-11
4181,0,0,19,0,-19
4182,0,0,52,0,-52
4183,1,0,7,0,-7
4184,0,0,6,0,-6
4185,1,1,1010,1341,331
4186,0,0,1,0,-1
4187,1,0,26,0,-26
4188,0,0,82,0,-82
4189,1,0,62,0,-62
4190,1,1,5,1360,1355
4191,0,0,20,0,-20
4192,0,0,2,0,-2
4193,0,0,24,0,-24
4194,1,0,48,0,-48
4195,1,0,9,0,-9
4196,0,0,154,0,-154
4197,1,1,266,1212,946
4198,1,0,27,0,-27
4199,0,0,4,0,-4
4200,1,1,318,1654,1336
4201,1,1,417,1302,885
4202,1,0,0,0,0
4203,0,0,30,0,-30
4204,0,0,12,0,-12
4205,0,0,88,0,-88
4206,0,0,30,0,-30
4207,0,0,2,0,-2
4208,0,0,14,0,-14
4209,1,1,145,1236,1091
4210,1,1,228,4149,3921
4211,0,0,83,0,-83
4212,0,0,38,0,-38
4213,1,1,221,1398,1177
4214,0,0,33,0,-33
4215,1,1,275,1646,1371
4216,1,0,97,0,-97
4217,1,0,19,0,-19
4218,0,0,80,0,-80
4219,1,1,25,1293,1268
4220,1,1,493,2026,1533
4221,0,0,87,0,-87
4222,0,0,136,0,-136
4223,1,0,32,0,-32
4224,1,1,154,1571,1417
4225,0,0,26,0,-26
4226,1,1,344,1233,889
4227,0,0,40,0,-40
4228,1,1,3071,1209,-1862
4229,1,1,478,1659,1181
4230,1,1,409,1439,1030
4231,1,1,1604,1483,-121
4232,1,1,555,1966,1411
4233,1,1,174,1274,1100
4234,1,1,182,1300,1118
4235,1,1,2212,1764,-448
4236,1,1,48,1283,1235
4237,0,0,100,0,-100
4238,1,1,845,1419,574
4239,1,1,315,1640,1325
4240,1,1,82,1373,1291
4241,1,0,5,0,-5
4242,0,0,48,0,-48
4243,1,1,233,1714,1481
4244,1,1,300,1543,1243
4245,1,1,347,1210,863
4246,0,0,27,0,-27
4247,0,0,25,0,-25
4248,1,1,448,1391,943
4249,0,0,43,0,-43
4250,1,1,127,1659,1532
4251,1,1,1656,1477,-179
4252,0,0,62,0,-62
4253,0,0,49,0,-49
4254,1,1,638,1303,665
4255,1,0,13,0,-13
4256,0,0,164,0,-164
4257,0,0,60,0,-60
4258,1,1,70,1329,1259
4259,1,1,267,2577,2310
4260,1,1,611,1232,621
4261,0,0,51,0,-51
4262,0,0,56,0,-56
4263,0,0,10,0,-10
4264,1,0,103,0,-103
4265,1,0,18,0,-18
4266,0,0,13,0,-13
4267,1,0,22,0,-22
4268,1,0,37,0,-37
4269,1,0,94,0,-94
4270,1,1,63,2528,2465
4271,0,0,82,0,-82
4272,0,0,27,0,-27
4273,0,0,25,0,-25
4274,0,0,31,0,-31
4275,1,1,92,1855,1763
4276,1,0,21,0,-21
4277,1,1,127,1996,1869
4278,1,0,6,0,-6
4279,1,1,366,1344,978
4280,1,0,11,0,-11
4281,1,0,17,0,-17
4282,0,0,230,0,-230
4283,1,1,52,1708,1656
4284,0,0,19,0,-19
4285,1,1,47,2185,2138
4286,0,0,53,0,-53
4287,1,1,544,1359,815
4288,0,0,64,0,-64
4289,0,0,13,0,-13
4290,0,0,17,0,-17
4291,0,0,92,0,-92
4292,1,1,719,2413,1694
4293,1,1,623,1214,591
4294,1,1,332,1203,871
4295,0,0,49,0,-49
4296,0,0,86,0,-86
4297,0,0,92,0,-92
4298,0,0,13,0,-13
4299,1,1,440,1214,774
4300,0,0,19,0,-19
4301,0,0,145,0,-145
4302,1,1,59,1462,1403
4303,1,1,1175,1571,396
4304,0,0,45,0,-45
4305,1,1,1285,1487,202
4306,0,0,19,0,-19
4307,1,1,98,3193,3095
4308,0,0,4,0,-4
4309,1,1,155,1786,1631
4310,1,1,145,1536,1391
4311,1,1,414,1624,1210
4312,0,0,36,0,-36
4313,0,0,6,0,-6
4314,0,0,221,0,-221
4315,1,1,439,2669,2230
4316,1,1,187,1604,1417
4317,1,1,358,2671,2313
4318,0,0,64,0,-64
4319,1,0,16,0,-16
4320,1,1,433,1246,813
4321,1,1,1314,2275,961
4322,1,0,121,0,-121
4323,1,1,165,1813,1648
4324,1,1,164,1865,1701
4325,1,1,565,1609,1044
4326,1,0,9,0,-9
4327,1,0,50,0,-50
4328,1,1,240,1517,1277
4329,0,0,15,0,-15
4330,1,1,538,1621,1083
4331,0,0,12,0,-12
4332,0,0,134,0,-134
4333,1,1,398,1606,1208
4334,0,0,12,0,-12
4335,1,1,317,1676,1359
4336,1,1,175,2815,2640
4337,1,0,7,0,-7
4338,1,0,83,0,-83
4339,1,1,343,1648,1305
4340,1,0,40,0,-40
4341,1,0,8,0,-8
4342,1,0,111,0,-111
4343,0,0,49,0,-49
4344,1,1,250,1850,1600
4345,1,1,831,3837,3006
4346,0,0,85,0,-85
4347,1,0,12,0,-12
4348,0,0,27,0,-27
4349,1,0,199,0,-199
4350,1,1,528,1237,709
4351,1,0,151,0,-151
4352,0,0,15,0,-15
4353,1,1,128,1299,1171
4354,1,0,8,0,-8
4355,0,0,75,0,-75
4356,1,0,46,0,-46
4357,0,0,271,0,-271
4358,0,0,68,0,-68
4359,1,0,46,0,-46
4360,0,0,22,0,-22
4361,0,0,187,0,-187
4362,0,0,49,0,-49
4363,1,1,411,1922,1511
4364,0,0,41,0,-41
4365,0,0,58,0,-58
4366,1,1,1011,1382,371
4367,1,1,269,1289,1020
4368,0,0,39,0,-39
4369,0,0,115,0,-115
4370,0,0,24,0,-24
4371,1,0,20,0,-20
4372,1,0,64,0,-64
4373,1,0,83,0,-83
4374,1,0,19,0,-19
4375,1,1,451,1237,786
4376,1,0,18,0,-18
4377,0,0,2,0,-2
4378,0,0,71,0,-71
4379,0,0,230,0,-230
4380,0,0,2,0,-2
4381,1,1,513,1543,1030
4382,1,0,44,0,-44
4383,1,1,628,1503,875
4384,0,0,4,0,-4
4385,0,0,14,0,-14
4386,1,1,1000,1244,244
4387,1,1,337,1247,910
4388,1,0,108,0,-108
4389,1,1,370,1346,976
4390,1,1,795,1331,536
4391,0,0,69,0,-69
4392,1,0,146,0,-146
4393,1,0,28,0,-28
4394,0,0,2,0,-2
4395,0,0,21,0,-21
4396,0,0,136,0,-136
4397,0,0,51,0,-51
4398,0,0,60,0,-60
4399,0,0,33,0,-33
4400,1,0,85,0,-85
4401,0,0,56,0,-56
4402,1,0,16,0,-16
4403,0,0,7,0,-7
4404,1,0,9,0,-9
4405,1,0,136,0,-136
4406,1,1,606,1252,646
4407,1,1,1471,1294,-177
4408,1,1,1045,1440,395
4409,0,0,236,0,-236
4410,1,0,83,0,-83
4411,1,0,1,0,-1
4412,0,0,72,0,-72
4413,0,0,124,0,-124
4414,1,0,44,0,-44
4415,0,0,109,0,-109
4416,1,1,499,1209,710
4417,1,1,345,4087,3742
4418,0,0,36,0,-36
4419,1,0,48,0,-48
4420,1,1,414,1353,939
4421,0,0,11,0,-11
4422,0,0,2,0,-2
4423,1,0,52,0,-52
4424,1,1,172,1895,1723
4425,0,0,9,0,-9
4426,0,0,38,0,-38
4427,1,0,56,0,-56
4428,1,1,126,1241,1115
4429,0,0,212,0,-212
4430,1,1,3461,1298,-2163
4431,1,1,13,1517,1504
4432,1,1,201,1348,1147
4433,1,0,48,0,-48
4434,1,1,873,1288,415
4435,0,0,69,0,-69
4436,0,0,104,0,-104
4437,0,0,48,0,-48
4438,1,0,60,0,-60
4439,0,0,4,0,-4
4440,0,0,132,0,-132
4441,1,1,808,1555,747
4442,0,0,31,0,-31
4443,1,0,52,0,-52
4444,1,0,138,0,-138
4445,1,0,54,0,-54
4446,0,0,9,0,-9
4447,1,1,332,1279,947
4448,1,1,323,2551,2228
4449,0,0,16,0,-16
4450,1,0,1,0,-1
4451,1,0,130,0,-130
4452,1,0,64,0,-64
4453,1,0,47,0,-47
4454,1,0,35,0,-35
4455,0,0,209,0,-209
4456,1,0,62,0,-62
4457,0,0,8,0,-8
4458,1,0,31,0,-31
4459,1,0,38,0,-38
4460,0,0,9,0,-9
4461,0,0,40,0,-40
4462,0,0,44,0,-44
4463,1,1,250,2035,1785
4464,0,0,23,0,-23
4465,0,0,50,0,-50
4466,0,0,16,0,-16
4467,1,0,82,0,-82
4468,1,1,285,1330,1045
4469,1,0,26,0,-26
4470,0,0,43,0,-43
4471,1,0,4,0,-4
4472,1,1,494,1973,1479
4473,0,0,52,0,-52
4474,0,0,52,0,-52
4475,1,1,963,1306,343
4476,0,0,3,0,-3
4477,1,1,177,1477,1300
4478,1,0,23,0,-23
4479,1,1,231,1377,1146
4480,1,1,370,2231,1861
4481,0,0,70,0,-70
4482,0,0,68,0,-68
4483,1,0,19,0,-19
4484,1,1,128,1243,1115
4485,1,0,1,0,-1
4486,1,0,19,0,-19
4487,0,0,66,0,-66
4488,1,0,12,0,-12
4489,0,0,17,0,-17
4490,1,0,143,0,-143
4491,1,1,121,1495,1374
4492,1,1,2135,1307,-828
4493,1,0,36,0,-36
4494,0,0,3,0,-3
4495,0,0,13,0,-13
4496,1,0,4,0,-4
4497,0,0,37,0,-37
4498,0,0,7,0,-7
4499,1,0,127,0,-127
4500,1,1,797,2825,2028
4501,1,1,31,1411,1380
4502,0,0,0,0,0
4503,0,0,31,0,-31
4504,1,1,184,1206,1022
4505,1,0,151,0,-151
4506,0,0,53,0,-53
4507,1,0,112,0,-112
4508,0,0,29,0,-29
4509,1,0,37,0,-37
4510,1,0,45,0,-45
4511,1,1,590,1204,614
4512,1,1,60,1261,1201
4513,1,1,104,1410,1306
4514,0,0,2,0,-2
4515,0,0,0,0,0
4516,1,0,8,0,-8
4517,1,0,7,0,-7
4518,1,1,134,1275,1141
4519,1,0,1,0,-1
4520,0,0,1,0,-1
4521,0,0,4,0,-4
4522,0,0,5,0,-5
4523,1,0,69,0,-69
4524,0,0,60,0,-60
4525,1,0,5,0,-5
4526,1,1,554,1720,1166
4527,0,0,22,0,-22
4528,0,0,30,0,-30
4529,1,1,351,2262,1911
4530,1,1,527,1224,697
4531,0,0,52,0,-52
4532,0,0,1,0,-1
4533,1,1,132,1513,1381
4534,0,0,250,0,-250
4535,1,1,875,1417,542
4536,0,0,97,0,-97
4537,1,1,214,1914,1700
4538,1,1,1614,1475,-139
4539,0,0,141,0,-141
4540,1,0,130,0,-130
4541,1,1,95,1297,1202
4542,0,0,55,0,-55
4543,1,0,49,0,-49
4544,0,0,19,0,-19
4545,1,0,36,0,-36
4546,0,0,1,0,-1
4547,0,0,14,0,-14
4548,1,1,20,2110,2090
4549,0,0,230,0,-230
4550,0,0,54,0,-54
4551,1,1,170,1436,1266
4552,1,1,339,2032,1693
4553,1,1,347,1395,1048
4554,1,1,104,1395,1291
4555,1,1,264,1565,1301
4556,1,0,11,0,-11
4557,0,0,100,0,-100
4558,1,1,524,1217,693
4559,0,0,104,0,-104
4560,0,0,24,0,-24
4561,0,0,28,0,-28
4562,0,0,23,0,-23
4563,1,1,193,1239,1046
4564,0,0,57,0,-57
4565,1,1,101,1954,1853
4566,0,0,39,0,-39
4567,1,0,1,0,-1
4568,0,0,35,0,-35
4569,1,1,264,1895,1631
4570,0,0,74,0,-74
4571,0,0,7,0,-7
4572,1,1,202,1433,1231
4573,1,1,1077,1544,467
4574,0,0,198,0,-198
4575,1,0,31,0,-31
4576,1,1,59,2122,2063
4577,1,1,333,1992,1659
4578,1,1,381,1323,942
4579,1,0,40,0,-40
4580,1,1,591,1239,648
4581,1,1,164,2057,1893
4582,0,0,8,0,-8
4583,1,0,44,0,-44
4584,1,0,49,0,-49
4585,1,0,73,0,-73
4586,1,1,161,1291,1130
4587,1,0,64,0,-64
4588,0,0,69,0,-69
4589,1,0,13,0,-13
4590,1,1,192,1509,1317
4591,0,0,101,0,-101
4592,0,0,320,0,-320
4593,0,0,16,0,-16
4594,0,0,70,0,-70
4595,1,1,104,1219,1115
4596,1,0,93,0,-93
4597,0,0,14,0,-14
4598,1,1,389,1228,839
4599,0,0,25,0,-25
4600,1,0,20,0,-20
4601,1,1,131,1419,1288
4602,1,0,86,0,-86
4603,1,0,50,0,-50
4604,0,0,127,0,-127
4605,0,0,43,0,-43
4606,0,0,13,0,-13
4607,0,0,5,0,-5
4608,0,0,104,0,-104
4609,1,1,714,1277,563
4610,1,1,329,1223,894
4611,1,0,63,0,-63
4612,0,0,23,0,-23
4613,0,0,0,0,0
4614,1,1,86,1834,1748
4615,0,0,7,0,-7
4616,1,0,30,0,-30
4617,0,0,28,0,-28
4618,1,0,0,0,0
4619,0,0,53,0,-53
4620,0,0,36,0,-36
4621,0,0,2,0,-2
4622,0,0,177,0,-177
4623,0,0,53,0,-53
4624,1,1,360,1303,943
4625,0,0,46,0,-46
4626,0,0,84,0,-84
4627,0,0,8,0,-8
4628,1,1,293,1580,1287
4629,0,0,18,0,-18
4630,1,0,71,0,-71
4631,1,0,124,0,-124
4632,0,0,45,0,-45
4633,0,0,31,0,-31
4634,1,0,15,0,-15
4635,1,0,1,0,-1
4636,0,0,52,0,-52
4637,1,1,135,1253,1118
4638,0,0,66,0,-66
4639,1,0,47,0,-47
4640,1,0,23,0,-23
4641,0,0,22,0,-22
4642,0,0,21,0,-21
4643,1,0,104,0,-104
4644,1,0,50,0,-50
4645,0,0,42,0,-42
4646,0,0,22,0,-22
4647,1,1,155,1296,1141
4648,0,0,63,0,-63
4649,1,1,71,1294,1223
4650,0,0,3,0,-3
4651,0,0,117,0,-117
4652,0,0,16,0,-16
4653,1,0,14,0,-14
4654,0,0,74,0,-74
4655,0,0,70,0,-70
4656,0,0,26,0,-26
4657,1,1,368,1324,956
4658,0,0,62,0,-62
4659,1,1,253,1774,1521
4660,1,0,124,0,-124
4661,0,0,96,0,-96
4662,0,0,46,0,-46
4663,0,0,139,0,-139
4664,1,0,0,0,0
4665,1,1,731,1203,472
4666,0,0,91,0,-91
4667,0,0,73,0,-73
4668,1,0,41,0,-41
4669,1,1,74,1321,1247
4670,1,0,28,0,-28
4671,1,1,70,1306,1236
4672,1,1,576,1316,740
4673,1,0,21,0,-21
4674,1,1,393,1533,1140
4675,0,0,24,0,-24
4676,0,0,114,0,-114
4677,1,1,115,1549,1434
4678,1,1,1053,1565,512
4679,1,0,17,0,-17
4680,0,0,29,0,-29
4681,0,0,3,0,-3
4682,1,1,140,2016,1876
4683,1,1,208,1259,1051
4684,1,0,2,0,-2
4685,1,1,110,1288,1178
4686,0,0,47,0,-47
4687,0,0,6,0,-6
4688,1,1,523,1371,848
4689,1,1,412,1208,796
4690,0,0,22,0,-22
4691,0,0,12,0,-12
4692,1,0,5,0,-5
4693,0,0,21,0,-21
4694,0,0,31,0,-31
4695,1,0,57,0,-57
4696,0,0,98,0,-98
4697,1,1,1117,1215,98
4698,1,0,76,0,-76
4699,1,0,36,0,-36
4700,0,0,8,0,-8
4701,0,0,21,0,-21
4702,1,0,78,0,-78
4703,1,1,126,2383,2257
4704,1,0,39,0,-39
4705,0,0,31,0,-31
4706,1,0,161,0,-161
4707,0,0,239,0,-239
4708,1,1,905,1212,307
4709,1,1,439,1236,797
4710,1,1,457,1363,906
4711,0,0,45,0,-45
4712,1,0,30,0,-30
4713,0,0,8,0,-8
4714,1,0,26,0,-26
4715,0,0,153,0,-153
4716,1,1,601,1293,692
4717,0,0,19,0,-19
4718,0,0,6,0,-6
4719,1,0,11,0,-11
4720,1,0,34,0,-34
4721,1,1,1668,2702,1034
4722,1,0,5,0,-5
4723,1,1,412,1370,958
4724,1,0,6,0,-6
4725,0,0,0,0,0
4726,1,0,156,0,-156
4727,0,0,57,0,-57
4728,1,1,153,1634,1481
4729,0,0,12,0,-12
4730,1,1,553,1462,909
4731,1,1,1254,2350,1096
4732,0,0,116,0,-116
4733,0,0,100,0,-100
4734,0,0,17,0,-17
4735,1,1,329,1554,1225
4736,0,0,74,0,-74
4737,1,0,57,0,-57
4738,1,1,422,1596,1174
4739,1,1,348,1482,1134
4740,1,1,38,2045,2007
4741,0,0,19,0,-19
4742,1,1,331,2421,2090
4743,1,1,123,1256,1133
4744,1,1,468,1279,811
4745,1,0,138,0,-138
4746,1,0,57,0,-57
4747,1,1,655,1345,690
4748,0,0,7,0,-7
4749,1,1,745,1519,774
4750,0,0,17,0,-17
4751,1,0,44,0,-44
4752,0,0,12,0,-12
4753,0,0,187,0,-187
4754,1,0,23,0,-23
4755,1,0,6,0,-6
4756,0,0,34,0,-34
4757,1,1,122,1436,1314
4758,1,1,38,1491,1453
4759,1,1,519,1708,1189
4760,1,0,32,0,-32
4761,0,0,19,0,-19
4762,1,0,26,0,-26
4763,0,0,3,0,-3
4764,1,1,338,1275,937
4765,0,0,18,0,-18
4766,0,0,159,0,-159
4767,1,1,600,1883,1283
4768,1,1,521,1207,686
4769,1,0,119,0,-119
4770,1,0,20,0,-20
4771,1,1,878,1339,461
4772,1,1,676,1286,610
4773,0,0,22,0,-22
4774,1,0,33,0,-33
4775,1,0,26,0,-26
4776,1,1,1109,1229,120
4777,0,0,85,0,-85
4778,0,0,25,0,-25
4779,1,0,108,0,-108
4780,1,0,4,0,-4
4781,1,0,25,0,-25
4782,0,0,20,0,-20
4783,1,1,163,1280,1117
4784,1,1,237,1299,1062
4785,1,0,41,0,-41
4786,1,0,90,0,-90
4787,0,0,3,0,-3
4788,1,0,16,0,-16
4789,0,0,16,0,-16
4790,0,0,50,0,-50
4791,0,0,9,0,-9
4792,1,1,122,1552,1430
4793,0,0,82,0,-82
4794,0,0,54,0,-54
4795,1,0,120,0,-120
4796,0,0,20,0,-20
4797,1,1,242,1492,1250
4798,1,0,13,0,-13
4799,1,1,1224,1297,73
4800,0,0,1,0,-1
4801,0,0,93,0,-93
4802,1,1,283,2125,1842
4803,1,0,9,0,-9
4804,1,1,327,1296,969
4805,1,1,293,1380,1087
4806,0,0,23,0,-23
4807,0,0,83,0,-83
4808,1,1,306,1235,929
4809,1,1,150,3635,3485
4810,1,1,861,2242,1381
4811,1,0,85,0,-85
4812,1,1,751,4087,3336
4813,1,1,242,1350,1108
4814,1,1,320,1639,1319
4815,1,1,1516,1625,109
4816,0,0,80,0,-80
4817,0,0,0,0,0
4818,1,0,19,0,-19
4819,0,0,16,0,-16
4820,1,1,470,1737,1267
4821,1,1,125,1804,1679
4822,1,0,9,0,-9
4823,1,0,38,0,-38
4824,1,1,541,1354,813
4825,1,1,952,1427,475
4826,1,1,1581,3229,1648
4827,1,1,738,1944,1206
4828,1,1,509,1246,737
4829,1,0,47,0,-47
4830,0,0,39,0,-39
4831,0,0,35,0,-35
4832,1,0,58,0,-58
4833,0,0,30,0,-30
4834,0,0,114,0,-114
4835,0,0,155,0,-155
4836,1,1,812,1262,450
4837,1,0,4,0,-4
4838,1,1,476,1476,1000
4839,0,0,77,0,-77
4840,0,0,32,0,-32
4841,1,1,550,1305,755
4842,0,0,28,0,-28
4843,1,0,25,0,-25
4844,0,0,20,0,-20
4845,1,0,1,0,-1
4846,0,0,35,0,-35
4847,1,0,110,0,-110
4848,0,0,4,0,-4
4849,1,0,6,0,-6
4850,1,0,79,0,-79
4851,1,1,424,1680,1256
4852,1,1,63,1309,1246
4853,0,0,52,0,-52
4854,0,0,19,0,-19
4855,0,0,8,0,-8
4856,1,1,71,1471,1400
4857,1,1,192,1449,1257
4858,1,1,183,1288,1105
4859,0,0,66,0,-66
4860,1,0,39,0,-39
4861,0,0,99,0,-99
4862,1,1,492,3781,3289
4863,0,0,23,0,-23
4864,0,0,114,0,-114
4865,0,0,18,0,-18
4866,0,0,35,0,-35
4867,1,1,1204,1235,31
4868,1,0,16,0,-16
4869,0,0,173,0,-173
4870,0,0,6,0,-6
4871,1,0,107,0,-107
4872,1,0,1,0,-1
4873,1,0,76,0,-76
4874,0,0,90,0,-90
4875,1,1,409,1538,1129
4876,0,0,59,0,-59
4877,1,1,165,1973,1808
4878,1,1,259,1223,964
4879,1,1,692,2186,1494
4880,1,0,15,0,-15
4881,0,0,48,0,-48
4882,1,1,636,1250,614
4883,1,0,13,0,-13
4884,0,0,72,0,-72
4885,0,0,38,0,-38
4886,0,0,76,0,-76
4887,0,0,16,0,-16
4888,1,0,27,0,-27
4889,0,0,121,0,-121
4890,0,0,19,0,-19
4891,1,1,177,1235,1058
4892,0,0,28,0,-28
4893,1,1,1452,1584,132
4894,1,0,13,0,-13
4895,1,0,52,0,-52
4896,0,0,22,0,-22
4897,0,0,29,0,-29
4898,1,0,92,0,-92
4899,1,0,58,0,-58
4900,1,0,5,0,-5
4901,0,0,55,0,-55
4902,1,1,325,1229,904
4903,0,0,31,0,-31
4904,1,1,148,1571,1423
4905,1,0,62,0,-62
4906,1,1,369,1608,1239
4907,1,1,1596,1286,-310
4908,0,0,18,0,-18
4909,1,1,347,2003,1656
4910,0,0,2,0,-2
4911,0,0,16,0,-16
4912,0,0,129,0,-129
4913,1,1,248,1388,1140
4914,1,1,1456,1826,370
4915,1,1,312,1228,916
4916,1,0,75,0,-75
4917,0,0,14,0,-14
4918,1,1,59,1549,1490
4919,0,0,19,0,-19
4920,0,0,36,0,-36
4921,1,0,80,0,-80
4922,1,1,108,1276,1168
4923,0,0,51,0,-51
4924,1,0,67,0,-67
4925,1,0,165,0,-165
4926,1,0,3,0,-3
4927,1,0,2,0,-2
4928,1,1,71,1809,1738
4929,0,0,3,0,-3
4930,1,0,40,0,-40
4931,1,1,133,3015,2882
4932,0,0,137,0,-137
4933,1,1,374,1291,917
4934,1,1,200,1461,1261
4935,1,1,284,1477,1193
4936,1,1,95,2459,2364
4937,0,0,12,0,-12
4938,0,0,0,0,0
4939,1,1,398,1288,890
4940,0,0,32,0,-32
4941,1,1,1358,1460,102
4942,1,0,37,0,-37
4943,0,0,54,0,-54
4944,0,0,67,0,-67
4945,0,0,11,0,-11
4946,1,1,214,2618,2404
4947,0,0,60,0,-60
4948,0,0,25,0,-25
4949,1,0,68,0,-68
4950,1,0,36,0,-36
4951,0,0,23,0,-23
4952,0,0,126,0,-126
4953,1,1,75,1745,1670
4954,1,0,6,0,-6
4955,1,0,29,0,-29
4956,0,0,58,0,-58
4957,0,0,18,0,-18
4958,0,0,36,0,-36
4959,0,0,8,0,-8
4960,1,1,115,2968,2853
4961,0,0,104,0,-104
4962,0,0,6,0,-6
4963,0,0,54,0,-54
4964,1,1,611,1725,1114
4965,0,0,59,0,-59
4966,1,1,233,1751,1518
4967,1,0,4,0,-4
4968,0,0,43,0,-43
4969,0,0,53,0,-53
4970,1,1,790,1310,520
4971,1,1,527,1934,1407
4972,1,1,216,1593,1377
4973,0,0,37,0,-37
4974,1,0,5,0,-5
4975,1,0,128,0,-128
4976,1,0,51,0,-51
4977,1,1,1135,1992,857
4978,1,1,532,1263,731
4979,0,0,0,0,0
4980,0,0,62,0,-62
4981,0,0,65,0,-65
4982,1,1,211,1215,1004
4983,0,0,81,0,-81
4984,0,0,4,0,-4
4985,1,0,57,0,-57
4986,1,1,131,1591,1460
4987,0,0,92,0,-92
4988,1,0,26,0,-26
4989,1,1,56,1535,1479
4990,1,0,60,0,-60
4991,0,0,81,0,-81
4992,1,0,53,0,-53
4993,0,0,117,0,-117
4994,1,1,229,1450,1221
4995,0,0,7,0,-7
4996,1,1,283,1384,1101
4997,0,0,71,0,-71
4998,1,0,7,0,-7
4999,0,0,41,0,-41
5000,1,1,414,1336,922
5001,1,0,9,0,-9
5002,1,1,1317,2339,1022
5003,1,0,77,0,-77
5004,0,0,26,0,-26
5005,1,0,31,0,-31
5006,0,0,91,0,-91
5007,1,1,255,1513,1258
5008,1,1,1497,1645,148
5009,0,0,92,0,-92
5010,1,1,447,1417,970
5011,0,0,46,0,-46
5012,1,0,0,0,0
5013,0,0,50,0,-50
5014,1,1,742,1728,986
5015,0,0,57,0,-57
5016,0,0,89,0,-89
5017,1,1,600,1257,657
5018,1,0,37,0,-37
5019,1,0,35,0,-35
5020,1,1,295,1629,1334
5021,1,0,18,0,-18
5022,1,1,39,1781,1742
5023,1,1,178,1590,1412
5024,1,0,3,0,-3
5025,0,0,60,0,-60
5026,1,1,311,1229,918
5027,0,0,47,0,-47
5028,0,0,79,0,-79
5029,1,1,78,2787,2709
5030,0,0,35,0,-35
5031,0,0,2,0,-2
5032,0,0,57,0,-57
5033,1,0,3,0,-3
5034,1,0,136,0,-136
5035,1,1,468,1210,742
5036,1,1,679,1461,782
5037,1,0,14,0,-14
5038,1,0,69,0,-69
5039,1,0,16,0,-16
5040,1,1,1249,1253,4
5041,1,0,59,0,-59
5042,0,0,114,0,-114
5043,0,0,4,0,-4
5044,1,0,61,0,-61
5045,1,1,325,1375,1050
5046,0,0,42,0,-42
5047,0,0,145,0,-145
5048,0,0,25,0,-25
5049,1,0,32,0,-32
5050,1,1,105,1742,1637
5051,1,0,60,0,-60
5052,0,0,46,0,-46
5053,0,0,40,0,-40
5054,0,0,1,0,-1
5055,1,0,205,0,-205
5056,1,0,102,0,-102
5057,1,0,69,0,-69
5058,0,0,3,0,-3
5059,1,0,2,0,-2
5060,1,1,195,1346,1151
5061,1,0,110,0,-110
5062,1,1,124,1377,1253
5063,0,0,50,0,-50
5064,1,1,998,1252,254
5065,1,0,90,0,-90
5066,0,0,5,0,-5
5067,0,0,5,0,-5
5068,1,1,487,1420,933
5069,1,0,87,0,-87
5070,0,0,173,0,-173
5071,1,0,3,0,-3
5072,1,0,29,0,-29
5073,0,0,48,0,-48
5074,1,0,29,0,-29
5075,1,1,2282,1301,-981
5076,1,0,38,0,-38
5077,1,0,41,0,-41
5078,1,0,38,0,-38
5079,1,1,590,1244,654
5080,1,1,229,1373,1144
5081,0,0,36,0,-36
5082,1,0,38,0,-38
5083,1,1,125,2200,2075
5084,0,0,22,0,-22
5085,0,0,33,0,-33
5086,1,0,121,0,-121
5087,0,0,56,0,-56
5088,1,0,75,0,-75
5089,0,0,4,0,-4
5090,1,0,23,0,-23
5091,1,0,26,0,-26
5092,0,0,15,0,-15
5093,0,0,39,0,-39
5094,1,0,53,0,-53
5095,1,1,1098,1339,241
5096,1,1,3776,1263,-2513
5097,1,0,20,0,-20
5098,0,0,88,0,-88
5099,0,0,38,0,-38
5100,1,1,117,1485,1368
5101,1,0,0,0,0
5102,1,0,21,0,-21
5103,1,0,97,0,-97
5104,1,0,6,0,-6
5105,1,1,503,1366,863
5106,0,0,119,0,-119
5107,1,1,377,2191,1814
5108,1,0,32,0,-32
5109,1,0,59,0,-59
5110,0,0,32,0,-32
5111,0,0,1,0,-1
5112,0,0,51,0,-51
5113,1,0,117,0,-117
5114,1,0,18,0,-18
5115,0,0,19,0,-19
5116,0,0,4,0,-4
5117,0,0,28,0,-28
5118,0,0,190,0,-190
5119,1,1,717,2594,1877
5120,1,0,35,0,-35
5121,0,0,12,0,-12
5122,1,0,95,0,-95
5123,1,0,2,0,-2
5124,1,1,263,1675,1412
5125,0,0,10,0,-10
5126,0,0,55,0,-55
5127,1,0,96,0,-96
5128,0,0,44,0,-44
5129,0,0,17,0,-17
5130,1,1,506,2027,1521
5131,0,0,5,0,-5
5132,1,1,2169,1483,-686
5133,1,0,56,0,-56
5134,1,1,56,1967,1911
5135,1,0,14,0,-14
5136,1,1,1524,1235,-289
5137,1,0,70,0,-70
5138,1,0,15,0,-15
5139,0,0,26,0,-26
5140,0,0,28,0,-28
5141,1,1,130,1564,1434
5142,0,0,39,0,-39
5143,1,0,4,0,-4
5144,0,0,20,0,-20
5145,1,0,27,0,-27
5146,0,0,73,0,-73
5147,1,0,123,0,-123
5148,1,0,18,0,-18
5149,1,0,74,0,-74
5150,0,0,3,0,-3
5151,1,1,176,1207,1031
5152,1,1,391,2597,2206
5153,0,0,12,0,-12
5154,0,0,148,0,-148
5155,0,0,5,0,-5
5156,0,0,6,0,-6
5157,1,0,157,0,-157
5158,0,0,8,0,-8
5159,1,0,45,0,-45
5160,1,0,12,0,-12
5161,1,1,140,1356,1216
5162,1,1,314,1607,1293
5163,0,0,78,0,-78
5164,1,1,97,2500,2403
5165,0,0,49,0,-49
5166,0,0,26,0,-26
5167,1,0,68,0,-68
5168,1,1,185,1275,1090
5169,1,1,182,1209,1027
5170,1,1,318,1407,1089
5171,1,1,192,1544,1352
5172,1,1,1249,1574,325
5173,1,1,1587,1240,-347
5174,1,0,200,0,-200
5175,0,0,10,0,-10
5176,1,1,1271,1215,-56
5177,0,0,3,0,-3
5178,1,1,361,1450,1089
5179,0,0,98,0,-98
5180,1,1,2087,1239,-848
5181,0,0,12,0,-12
5182,0,0,68,0,-68
5183,0,0,23,0,-23
5184,0,0,107,0,-107
5185,1,0,119,0,-119
5186,1,1,710,1547,837
5187,0,0,17,0,-17
5188,1,1,220,1412,1192
5189,1,0,161,0,-161
5190,0,0,103,0,-103
5191,0,0,113,0,-113
5192,1,0,102,0,-102
5193,0,0,25,0,-25
5194,0,0,44,0,-44
5195,1,1,972,1268,296
5196,1,1,276,1386,1110
5197,1,1,170,1699,1529
5198,0,0,53,0,-53
5199,1,1,1185,1799,614
5200,0,0,42,0,-42
5201,0,0,24,0,-24
5202,1,0,32,0,-32
5203,1,0,50,0,-50
5204,1,0,3,0,-3
5205,1,0,56,0,-56
5206,0,0,57,0,-57
5207,1,1,216,1284,1068
5208,0,0,8,0,-8
5209,1,1,281,1417,1136
5210,1,1,478,1878,1400
5211,1,1,1206,1536,330
5212,0,0,78,0,-78
5213,1,0,7,0,-7
5214,1,0,36,0,-36
5215,1,0,93,0,-93
5216,1,0,124,0,-124
5217,0,0,0,0,0
5218,0,0,22,0,-22
5219,0,0,78,0,-78
5220,1,0,5,0,-5
5221,1,1,416,1649,1233
5222,0,0,60,0,-60
5223,1,1,468,1334,866
5224,0,0,120,0,-120
5225,0,0,35,0,-35
5226,1,1,394,1960,1566
5227,1,1,298,1293,995
5228,1,1,962,1509,547
5229,1,1,724,1239,515
5230,1,1,533,1725,1192
5231,1,1,745,1282,537
5232,1,1,327,1314,987
5233,0,0,70,0,-70
5234,1,0,150,0,-150
5235,0,0,123,0,-123
5236,1,0,147,0,-147
5237,1,0,0,0,0
5238,0,0,27,0,-27
5239,0,0,11,0,-11
5240,1,0,32,0,-32
5241,0,0,2,0,-2
5242,1,0,27,0,-27
5243,0,0,5,0,-5
5244,0,0,53,0,-53
5245,0,0,34,0,-34
5246,1,0,238,0,-238
5247,1,0,2,0,-2
5248,1,1,465,1602,1137
5249,1,0,19,0,-19
5250,0,0,47,0,-47
5251,1,0,88,0,-88
5252,1,0,6,0,-6
5253,0,0,98,0,-98
5254,0,0,8,0,-8
5255,1,0,54,0,-54
5256,0,0,9,0,-9
5257,1,1,2176,1534,-642
5258,1,0,39,0,-39
5259,1,1,131,1625,1494
5260,1,1,151,1499,1348
5261,1,0,206,0,-206
5262,0,0,55,0,-55
5263,1,1,677,1530,853
5264,0,0,33,0,-33
5265,1,0,55,0,-55
5266,1,1,1476,1733,257
5267,0,0,79,0,-79
5268,1,1,338,1930,1592
5269,0,0,86,0,-86
5270,0,0,13,0,-13
5271,1,0,7,0,-7
5272,0,0,5,0,-5
5273,0,0,4,0,-4
5274,1,0,9,0,-9
5275,1,1,771,2680,1909
5276,0,0,28,0,-28
5277,0,0,104,0,-104
5278,1,1,275,1817,1542
5279,1,1,633,1459,826
5280,0,0,35,0,-35
5281,1,0,88,0,-88
5282,1,0,24,0,-24
5283,0,0,129,0,-129
5284,1,0,27,0,-27
5285,0,0,96,0,-96
5286,1,1,343,1275,932
5287,0,0,11,0,-11
5288,1,1,999,2604,1605
5289,0,0,7,0,-7
5290,1,0,6,0,-6
5291,1,0,32,0,-32
5292,1,0,31,0,-31
5293,1,0,20,0,-20
5294,1,0,17,0,-17
5295,0,0,25,0,-25
5296,1,0,0,0,0
5297,1,0,24,0,-24
5298,1,1,1469,2075,606
5299,1,1,446,1619,1173
5300,1,0,14,0,-14
5301,1,0,22,0,-22
5302,1,1,572,1226,654
5303,0,0,11,0,-11
5304,1,0,19,0,-19
5305,0,0,12,0,-12
5306,1,0,183,0,-183
5307,0,0,5,0,-5
5308,1,0,9,0,-9
5309,0,0,326,0,-326
5310,1,1,371,1330,959
5311,1,0,35,0,-35
5312,1,0,31,0,-31
5313,0,0,7,0,-7
5314,0,0,11,0,-11
5315,1,1,299,2173,1874
5316,1,1,314,2077,1763
5317,1,0,97,0,-97
5318,1,0,54,0,-54
5319,1,1,193,3847,3654
5320,0,0,130,0,-130
5321,0,0,39,0,-39
5322,1,1,827,2159,1332
5323,0,0,104,0,-104
5324,1,0,9,0,-9
5325,1,1,212,1200,988
5326,1,1,637,2249,1612
5327,1,0,13,0,-13
5328,1,0,12,0,-12
5329,1,1,61,2201,2140
5330,0,0,75,0,-75
5331,0,0,34,0,-34
5332,0,0,9,0,-9
5333,0,0,30,0,-30
5334,1,1,710,1640,930
5335,0,0,19,0,-19
5336,1,0,1,0,-1
5337,1,1,904,1611,707
5338,1,0,18,0,-18
5339,1,1,499,1747,1248
5340,1,0,116,0,-116
5341,0,0,159,0,-159
5342,1,1,263,1209,946
5343,0,0,25,0,-25
5344,0,0,33,0,-33
5345,1,1,366,1213,847
5346,0,0,126,0,-126
5347,0,0,68,0,-68
5348,1,1,1022,1252,230
5349,1,0,23,0,-23
5350,0,0,21,0,-21
5351,1,1,1299,1444,145
5352,1,0,88,0,-88
5353,0,0,206,0,-206
5354,0,0,23,0,-23
5355,0,0,8,0,-8
5356,1,1,391,1202,811
5357,1,0,3,0,-3
5358,0,0,62,0,-62
5359,0,0,2,0,-2
5360,1,0,63,0,-63
5361,1,1,536,1575,1039
5362,1,0,218,0,-218
5363,1,1,172,1346,1174
5364,0,0,66,0,-66
5365,1,0,67,0,-67
5366,0,0,44,0,-44
5367,0,0,72,0,-72
5368,1,1,283,1359,1076
5369,1,1,264,1857,1593
5370,0,0,9,0,-9
5371,0,0,1,0,-1
5372,1,1,648,1452,804
5373,0,0,68,0,-68
5374,0,0,9,0,-9
5375,0,0,82,0,-82
5376,1,1,146,1506,1360
5377,1,0,43,0,-43
5378,1,1,446,1203,757
5379,0,0,48,0,-48
5380,1,1,1018,1278,260
5381,1,1,192,1555,1363
5382,0,0,35,0,-35
5383,1,0,16,0,-16
5384,1,1,726,1221,495
5385,0,0,31,0,-31
5386,1,0,16,0,-16
5387,1,0,19,0,-19
5388,1,1,436,2027,1591
5389,0,0,24,0,-24
5390,0,0,58,0,-58
5391,1,1,142,1763,1621
5392,1,1,150,1340,1190
5393,0,0,106,0,-106
5394,1,1,1360,1548,188
5395,1,1,390,1587,1197
5396,0,0,58,0,-58
5397,0,0,17,0,-17
5398,1,1,278,1286,1008
5399,0,0,131,0,-131
5400,1,0,43,0,-43
5401,1,0,40,0,-40
5402,0,0,152,0,-152
5403,1,0,164,0,-164
5404,1,1,392,1359,967
5405,1,1,175,1726,1551
5406,0,0,4,0,-4
5407,1,0,0,0,0
5408,1,0,103,0,-103
5409,0,0,10,0,-10
5410,0,0,11,0,-11
5411,0,0,85,0,-85
5412,1,1,607,1467,860
5413,1,0,66,0,-66
5414,0,0,96,0,-96
5415,0,0,141,0,-141
5416,1,1,146,1531,1385
5417,1,0,22,0,-22
5418,1,1,1127,1234,107
5419,1,0,19,0,-19
5420,0,0,70,0,-70
5421,0,0,36,0,-36
5422,1,1,282,1491,1209
5423,1,0,26,0,-26
5424,0,0,9,0,-9
5425,1,0,2,0,-2
5426,1,1,121,1347,1226
5427,0,0,63,0,-63
5428,1,0,33,0,-33
5429,1,1,83,1356,1273
5430,1,1,24,1226,1202
5431,1,1,57,1507,1450
5432,0,0,45,0,-45
5433,1,1,406,1880,1474
5434,1,0,116,0,-116
5435,0,0,19,0,-19
5436,1,0,98,0,-98
5437,1,0,5,0,-5
5438,1,1,355,1423,1068
5439,0,0,2,0,-2
5440,0,0,3,0,-3
5441,1,0,5,0,-5
5442,0,0,107,0,-107
5443,0,0,7,0,-7
5444,1,1,62,1387,1325
5445,0,0,32,0,-32
5446,1,0,136,0,-136
5447,1,1,3300,1266,-2034
5448,1,0,26,0,-26
5449,0,0,90,0,-90
5450,0,0,14,0,-14
5451,0,0,2,0,-2
5452,1,1,225,1242,1017
5453,0,0,26,0,-26
5454,0,0,5,0,-5
5455,0,0,18,0,-18
5456,1,0,12,0,-12
5457,1,0,2,0,-2
5458,1,0,35,0,-35
5459,0,0,10,0,-10
5460,1,1,864,1218,354
5461,1,1,493,1245,752
5462,1,1,35,1237,1202
5463,1,1,247,1582,1335
5464,1,1,268,1239,971
5465,0,0,119,0,-119
5466,0,0,27,0,-27
5467,1,1,638,1907,1269
5468,1,1,431,2666,2235
5469,0,0,10,0,-10
5470,1,0,0,0,0
5471,1,1,249,1396,1147
5472,1,1,557,1818,1261
5473,0,0,64,0,-64
5474,1,1,236,1275,1039
5475,0,0,157,0,-157
5476,1,1,251,1228,977
5477,1,1,97,1533,1436
5478,1,1,503,1843,1340
5479,1,0,76,0,-76
5480,1,0,42,0,-42
5481,0,0,9,0,-9
5482,0,0,0,0,0
5483,0,0,4,0,-4
5484,1,1,1722,1577,-145
5485,0,0,1,0,-1
5486,1,0,16,0,-16
5487,1,1,511,1688,1177
5488,1,0,93,0,-93
5489,0,0,96,0,-96
5490,0,0,72,0,-72
5491,1,0,25,0,-25
5492,0,0,55,0,-55
5493,1,1,119,1505,1386
5494,0,0,5,0,-5
5495,1,0,12,0,-12
5496,1,1,404,1200,796
5497,1,0,117,0,-117
5498,1,0,50,0,-50
5499,0,0,133,0,-133
5500,0,0,2,0,-2
5501,1,0,22,0,-22
5502,1,0,6,0,-6
5503,0,0,14,0,-14
5504,0,0,25,0,-25
5505,0,0,13,0,-13
5506,0,0,47,0,-47
5507,1,0,41,0,-41
5508,1,1,346,1381,1035
5509,1,0,2,0,-2
5510,0,0,4,0,-4
5511,0,0,34,0,-34
5512,0,0,39,0,-39
5513,1,1,910,1243,333
5514,1,0,1,0,-1
5515,0,0,92,0,-92
5516,1,1,334,1204,870
5517,1,0,19,0,-19
5518,1,0,91,0,-91
5519,1,0,71,0,-71
5520,0,0,43,0,-43
5521,1,1,104,1611,1507
5522,0,0,287,0,-287
5523,1,1,516,1506,990
5524,1,0,213,0,-213
5525,0,0,47,0,-47
5526,0,0,6,0,-6
5527,0,0,71,0,-71
5528,0,0,86,0,-86
5529,0,0,149,0,-149
5530,1,1,483,1502,1019
5531,0,0,2,0,-2
5532,1,0,10,0,-10
5533,1,1,356,2373,2017
5534,1,0,85,0,-85
5535,1,0,8,0,-8
5536,1,1,645,1944,1299
5537,1,1,420,1309,889
5538,1,1,328,1344,1016
5539,0,0,52,0,-52
5540,1,0,14,0,-14
5541,0,0,11,0,-11
5542,1,0,111,0,-111
5543,1,1,145,1307,1162
5544,1,1,223,1497,1274
5545,1,0,31,0,-31
5546,1,0,12,0,-12
5547,1,1,1564,1590,26
5548,1,1,35,1568,1533
5549,1,1,444,1363,919
5550,1,1,368,1202,834
5551,1,0,50,0,-50
5552,0,0,85,0,-85
5553,0,0,187,0,-187
5554,1,0,62,0,-62
5555,0,0,163,0,-163
5556,1,1,254,1443,1189
5557,0,0,39,0,-39
5558,1,0,22,0,-22
5559,1,0,1,0,-1
5560,0,0,36,0,-36
5561,0,0,141,0,-141
5562,0,0,58,0,-58
5563,0,0,9,0,-9
5564,1,1,191,2170,1979
5565,0,0,67,0,-67
5566,0,0,28,0,-28
5567,0,0,10,0,-10
5568,1,0,57,0,-57
5569,0,0,11,0,-11
5570,1,1,2141,2322,181
5571,0,0,0,0,0
5572,1,0,52,0,-52
5573,0,0,28,0,-28
5574,1,0,67,0,-67
5575,0,0,25,0,-25
5576,1,1,150,4348,4198
5577,0,0,29,0,-29
5578,1,1,391,1613,1222
5579,0,0,28,0,-28
5580,1,1,1022,1259,237
5581,0,0,48,0,-48
5582,1,1,328,1345,1017
5583,1,1,507,1890,1383
5584,1,0,57,0,-57
5585,0,0,49,0,-49
5586,0,0,40,0,-40
5587,1,0,148,0,-148
5588,1,1,417,1681,1264
5589,0,0,40,0,-40
5590,0,0,56,0,-56
5591,1,0,77,0,-77
5592,0,0,156,0,-156
5593,1,1,501,3209,2708
5594,0,0,29,0,-29
5595,0,0,0,0,0
5596,1,0,20,0,-20
5597,0,0,26,0,-26
5598,0,0,16,0,-16
5599,1,1,191,1247,1056
5600,1,1,358,1591,1233
5601,0,0,29,0,-29
5602,1,1,1042,1709,667
5603,0,0,78,0,-78
5604,1,1,96,1805,1709
5605,1,1,316,1375,1059
5606,0,0,127,0,-127
5607,0,0,0,0,0
5608,1,1,191,1401,1210
5609,1,0,47,0,-47
5610,0,0,35,0,-35
5611,1,0,10,0,-10
5612,1,0,202,0,-202
5613,1,0,90,0,-90
5614,1,1,32,1803,1771
5615,1,0,58,0,-58
5616,1,1,241,1501,1260
5617,1,1,1407,1366,-41
5618,1,1,800,1228,428
5619,0,0,73,0,-73
5620,1,1,39,1723,1684
5621,1,0,17,0,-17
5622,0,0,8,0,-8
5623,1,0,30,0,-30
5624,1,1,2838,1711,-1127
5625,0,0,59,0,-59
5626,0,0,7,0,-7
5627,1,1,536,1264,728
5628,1,1,483,1379,896
5629,0,0,78,0,-78
5630,1,1,46,1447,1401
5631,0,0,150,0,-150
5632,1,1,8,1324,1316
5633,1,0,1,0,-1
5634,0,0,104,0,-104
5635,1,1,67,1428,1361
5636,0,0,11,0,-11
5637,0,0,104,0,-104
5638,1,0,8,0,-8
5639,0,0,17,0,-17
5640,1,0,8,0,-8
5641,1,0,45,0,-45
5642,1,1,217,1232,1015
5643,0,0,50,0,-50
5644,0,0,14,0,-14
5645,1,1,21,1422,1401
5646,1,0,221,0,-221
5647,1,0,16,0,-16
5648,0,0,6,0,-6
5649,1,1,319,1484,1165
5650,1,0,17,0,-17
5651,1,1,170,1343,1173
5652,0,0,82,0,-82
5653,1,0,23,0,-23
5654,1,0,146,0,-146
5655,1,1,841,1202,361
5656,0,0,23,0,-23
5657,1,1,129,1274,1145
5658,1,0,9,0,-9
5659,1,1,474,2592,2118
5660,0,0,14,0,-14
5661,1,0,13,0,-13
5662,1,0,80,0,-80
5663,0,0,37,0,-37
5664,0,0,245,0,-245
5665,1,1,682,1367,685
5666,1,0,62,0,-62
5667,1,1,159,1704,1545
5668,1,1,1773,1248,-525
5669,0,0,54,0,-54
5670,1,1,925,2451,1526
5671,1,0,7,0,-7
5672,1,1,386,1900,1514
5673,1,0,155,0,-155
5674,1,1,189,2468,2279
5675,1,0,89,0,-89
5676,0,0,2,0,-2
5677,0,0,33,0,-33
5678,1,0,6,0,-6
5679,1,1,412,1572,1160
5680,0,0,40,0,-40
5681,1,1,350,2560,2210
5682,1,1,1384,1836,452
5683,1,1,141,1375,1234
5684,1,0,45,0,-45
5685,0,0,35,0,-35
5686,0,0,84,0,-84
5687,1,0,13,0,-13
5688,1,0,117,0,-117
5689,1,0,126,0,-126
5690,0,0,21,0,-21
5691,1,0,8,0,-8
5692,1,1,197,1217,1020
5693,1,1,133,2012,1879
5694,0,0,66,0,-66
5695,1,1,124,4519,4395
5696,0,0,20,0,-20
5697,1,1,292,1808,1516
5698,1,1,91,1864,1773
5699,1,0,33,0,-33
5700,1,0,46,0,-46
5701,0,0,231,0,-231
5702,0,0,109,0,-109
5703,1,1,264,1834,1570
5704,0,0,32,0,-32
5705,0,0,0,0,0
5706,1,1,189,1301,1112
5707,1,1,513,1667,1154
5708,1,0,50,0,-50
5709,0,0,11,0,-11
5710,1,1,629,1217,588
5711,1,0,11,0,-11
5712,1,1,388,1222,834
5713,1,1,327,1472,1145
5714,0,0,13,0,-13
5715,0,0,66,0,-66
5716,1,1,822,1515,693
5717,1,1,596,1740,1144
5718,1,1,454,1307,853
5719,0,0,86,0,-86
5720,1,0,117,0,-117
5721,1,0,21,0,-21
5722,1,0,37,0,-37
5723,0,0,7,0,-7
5724,1,0,0,0,0
5725,1,0,40,0,-40
5726,1,0,43,0,-43
5727,0,0,83,0,-83
5728,0,0,20,0,-20
5729,1,1,42,1325,1283
5730,1,1,1009,2109,1100
5731,1,1,490,1240,750
5732,1,1,601,1220,619
5733,1,1,291,1219,928
5734,1,1,349,1275,926
5735,0,0,126,0,-126
5736,1,0,19,0,-19
5737,0,0,38,0,-38
5738,1,0,48,0,-48
5739,0,0,63,0,-63
5740,0,0,48,0,-48
5741,1,1,1175,1461,286
5742,0,0,40,0,-40
5743,0,0,40,0,-40
5744,0,0,19,0,-19
5745,0,0,73,0,-73
5746,1,0,129,0,-129
5747,0,0,52,0,-52
5748,0,0,117,0,-117
5749,0,0,6,0,-6
5750,1,0,77,0,-77
5751,0,0,130,0,-130
5752,0,0,22,0,-22
5753,0,0,38,0,-38
5754,1,1,390,2492,2102
5755,1,0,19,0,-19
5756,0,0,8,0,-8
5757,1,0,50,0,-50
5758,0,0,10,0,-10
5759,1,1,510,1202,692
5760,1,0,8,0,-8
5761,1,1,330,1269,939
5762,1,1,296,1748,1452
5763,0,0,138,0,-138
5764,0,0,37,0,-37
5765,1,1,821,1319,498
5766,0,0,150,0,-150
5767,1,0,27,0,-27
5768,0,0,37,0,-37
5769,1,0,25,0,-25
5770,1,1,649,1426,777
5771,0,0,51,0,-51
5772,1,1,52,1205,1153
5773,0,0,44,0,-44
5774,1,0,67,0,-67
5775,1,0,31,0,-31
5776,1,1,151,1572,1421
5777,0,0,176,0,-176
5778,1,0,45,0,-45
5779,1,1,121,2035,1914
5780,0,0,12,0,-12
5781,0,0,182,0,-182
5782,1,1,269,1259,990
5783,1,0,9,0,-9
5784,1,1,307,1362,1055
5785,1,0,11,0,-11
5786,1,1,358,2350,1992
5787,1,0,77,0,-77
5788,1,0,153,0,-153
5789,1,1,589,2146,1557
5790,0,0,10,0,-10
5791,1,1,446,1744,1298
5792,1,1,341,1893,1552
5793,0,0,118,0,-118
5794,0,0,42,0,-42
5795,1,0,0,0,0
5796,0,0,52,0,-52
5797,1,0,21,0,-21
5798,0,0,11,0,-11
5799,1,1,446,1459,1013
5800,0,0,65,0,-65
5801,1,1,723,2638,1915
5802,1,1,320,1291,971
5803,1,1,258,2201,1943
5804,1,1,692,1668,976
5805,0,0,182,0,-182
5806,1,0,61,0,-61
5807,1,0,77,0,-77
5808,1,0,142,0,-142
5809,1,0,42,0,-42
5810,0,0,28,0,-28
5811,0,0,28,0,-28
5812,1,1,517,1553,1036
5813,1,1,401,4378,3977
5814,1,0,35,0,-35
5815,1,0,32,0,-32
5816,0,0,5,0,-5
5817,1,1,525,1466,941
5818,1,0,89,0,-89
5819,1,1,202,1264,1062
5820,1,1,382,1205,823
5821,1,1,438,1677,1239
5822,0,0,47,0,-47
5823,1,0,5,0,-5
5824,1,0,40,0,-40
5825,1,0,58,0,-58
5826,1,0,3,0,-3
5827,0,0,21,0,-21
5828,0,0,66,0,-66
5829,0,0,38,0,-38
5830,1,0,6,0,-6
5831,0,0,124,0,-124
5832,1,0,88,0,-88
5833,1,1,811,1564,753
5834,1,0,149,0,-149
5835,0,0,3,0,-3
5836,1,1,53,2322,2269
5837,0,0,127,0,-127
5838,1,1,780,1215,435
5839,0,0,31,0,-31
5840,1,0,24,0,-24
5841,1,1,1518,1411,-107
5842,1,1,672,1729,1057
5843,1,0,22,0,-22
5844,0,0,0,0,0
5845,1,0,30,0,-30
5846,0,0,43,0,-43
5847,0,0,32,0,-32
5848,1,1,1816,2006,190
5849,0,0,63,0,-63
5850,1,0,44,0,-44
5851,1,1,1571,1301,-270
5852,0,0,0,0,0
5853,0,0,36,0,-36
5854,1,1,432,2609,2177
5855,1,1,37,1464,1427
5856,0,0,105,0,-105
5857,0,0,152,0,-152
5858,1,1,1502,1206,-296
5859,1,1,739,1220,481
5860,0,0,52,0,-52
5861,1,1,862,1582,720
5862,0,0,22,0,-22
5863,1,1,62,3134,3072
5864,0,0,37,0,-37
5865,0,0,58,0,-58
5866,1,0,37,0,-37
5867,1,0,16,0,-16
5868,1,0,37,0,-37
5869,1,0,60,0,-60
5870,1,0,7,0,-7
5871,0,0,42,0,-42
5872,1,0,6,0,-6
5873,1,0,26,0,-26
5874,1,0,123,0,-123
5875,0,0,37,0,-37
5876,1,0,70,0,-70
5877,1,0,120,0,-120
5878,1,0,33,0,-33
5879,1,0,8,0,-8
5880,1,0,94,0,-94
5881,1,1,198,1430,1232
5882,0,0,9,0,-9
5883,1,0,23,0,-23
5884,1,1,156,2915,2759
5885,1,1,264,1960,1696
5886,1,0,66,0,-66
5887,1,1,930,1268,338
5888,0,0,5,0,-5
5889,0,0,94,0,-94
5890,1,1,169,2482,2313
5891,0,0,58,0,-58
5892,0,0,73,0,-73
5893,0,0,6,0,-6
5894,0,0,89,0,-89
5895,0,0,102,0,-102
5896,1,1,549,2031,1482
5897,1,0,24,0,-24
5898,1,0,0,0,0
5899,0,0,78,0,-78
5900,1,0,132,0,-132
5901,0,0,8,0,-8
5902,1,0,118,0,-118
5903,1,1,718,1601,883
5904,1,1,767,1316,549
5905,1,1,4111,1490,-2621
5906,0,0,51,0,-51
5907,1,1,283,1377,1094
5908,0,0,1,0,-1
5909,0,0,10,0,-10
5910,1,0,18,0,-18
5911,0,0,107,0,-107
5912,0,0,80,0,-80
5913,1,1,130,1330,1200
5914,1,0,87,0,-87
5915,1,0,0,0,0
5916,0,0,10,0,-10
5917,1,1,82,1479,1397
5918,1,1,432,1496,1064
5919,1,0,44,0,-44
5920,0,0,117,0,-117
5921,1,0,44,0,-44
5922,0,0,37,0,-37
5923,1,0,17,0,-17
5924,0,0,31,0,-31
5925,1,0,25,0,-25
5926,0,0,15,0,-15
5927,1,1,323,1506,1183
5928,0,0,35,0,-35
5929,1,1,148,1343,1195
5930,1,1,1308,1461,153
5931,1,0,39,0,-39
5932,1,0,19,0,-19
5933,1,0,52,0,-52
5934,1,0,56,0,-56
5935,1,0,4,0,-4
5936,1,0,59,0,-59
5937,0,0,53,0,-53
5938,1,1,168,1400,1232
5939,1,1,310,2763,2453
5940,0,0,42,0,-42
5941,1,1,533,1330,797
5942,0,0,14,0,-14
5943,1,1,1795,1628,-167
5944,1,0,55,0,-55
5945,1,0,0,0,0
5946,1,1,187,1366,1179
5947,0,0,71,0,-71
5948,1,0,94,0,-94
5949,1,1,1239,1485,246
5950,1,0,78,0,-78
5951,0,0,19,0,-19
5952,1,1,774,1324,550
5953,1,1,213,1264,1051
5954,0,0,30,0,-30
5955,1,0,156,0,-156
5956,0,0,176,0,-176
5957,0,0,242,0,-242
5958,1,1,179,1480,1301
5959,1,0,8,0,-8
5960,0,0,39,0,-39
5961,1,0,14,0,-14
5962,0,0,11,0,-11
5963,0,0,110,0,-110
5964,0,0,156,0,-156
5965,0,0,37,0,-37
5966,1,0,16,0,-16
5967,0,0,1,0,-1
5968,0,0,89,0,-89
5969,1,0,3,0,-3
5970,1,1,834,1864,1030
5971,1,1,400,1249,849
5972,1,0,6,0,-6
5973,0,0,64,0,-64
5974,0,0,168,0,-168
5975,0,0,25,0,-25
5976,1,1,443,1886,1443
5977,0,0,45,0,-45
5978,1,0,36,0,-36
5979,1,0,69,0,-69
5980,1,1,284,2794,2510
5981,0,0,64,0,-64
5982,0,0,183,0,-183
5983,0,0,23,0,-23
5984,1,0,96,0,-96
5985,0,0,39,0,-39
5986,1,1,248,1350,1102
5987,1,0,7,0,-7
5988,1,0,34,0,-34
5989,1,0,93,0,-93
5990,1,0,52,0,-52
5991,1,0,141,0,-141
5992,0,0,61,0,-61
5993,1,1,611,1856,1245
5994,1,1,852,2331,1479
5995,1,1,672,2198,1526
5996,1,1,95,2962,2867
5997,1,0,5,0,-5
5998,1,1,1713,1234,-479
5999,1,1,874,1437,563
6000,1,0,77,0,-77
6001,1,1,504,1383,879
6002,1,1,1287,1385,98
6003,0,0,17,0,-17
6004,1,1,40,1295,1255
6005,0,0,6,0,-6
6006,1,1,190,1351,1161
6007,1,0,10,0,-10
6008,0,0,26,0,-26
6009,0,0,111,0,-111
6010,1,0,8,0,-8
6011,1,1,258,1343,1085
6012,1,0,42,0,-42
6013,1,0,89,0,-89
6014,0,0,69,0,-69
6015,0,0,18,0,-18
6016,0,0,39,0,-39
6017,0,0,210,0,-210
6018,1,0,8,0,-8
6019,1,1,704,1385,681
6020,0,0,64,0,-64
6021,0,0,8,0,-8
6022,0,0,22,0,-22
6023,0,0,0,0,0
6024,0,0,3,0,-3
6025,1,1,1647,1558,-89
6026,0,0,205,0,-205
6027,0,0,89,0,-89
6028,0,0,1,0,-1
6029,1,0,14,0,-14
6030,0,0,20,0,-20
6031,1,0,11,0,-11
6032,1,1,1481,5174,3693
6033,1,1,626,2021,1395
6034,0,0,44,0,-44
6035,1,1,196,1437,1241
6036,0,0,47,0,-47
6037,1,1,101,1549,1448
6038,1,1,597,1535,938
6039,0,0,32,0,-32
6040,1,1,42,1792,1750
6041,1,0,2,0,-2
6042,1,1,892,1221,329
6043,0,0,39,0,-39
6044,1,0,117,0,-117
6045,1,0,5,0,-5
6046,0,0,13,0,-13
6047,1,0,8,0,-8
6048,1,0,147,0,-147
6049,1,0,9,0,-9
6050,0,0,61,0,-61
6051,1,0,22,0,-22
6052,1,0,10,0,-10
6053,1,1,610,1513,903
6054,0,0,27,0,-27
6055,0,0,5,0,-5
6056,1,0,14,0,-14
6057,1,1,1061,1404,343
6058,1,1,649,1319,670
6059,1,0,60,0,-60
6060,0,0,16,0,-16
6061,1,0,31,0,-31
6062,1,1,164,1316,1152
6063,1,1,914,1371,457
6064,1,0,18,0,-18
6065,0,0,29,0,-29
6066,0,0,10,0,-10
6067,1,0,102,0,-102
6068,1,0,22,0,-22
6069,1,1,753,1460,707
6070,1,1,352,1230,878
6071,0,0,28,0,-28
6072,1,1,609,1230,621
6073,0,0,46,0,-46
6074,1,1,31,2518,2487
6075,0,0,77,0,-77
6076,0,0,1,0,-1
6077,0,0,26,0,-26
6078,1,1,566,1591,1025
6079,1,1,985,1225,240
6080,0,0,39,0,-39
6081,1,1,210,1300,1090
6082,0,0,117,0,-117
6083,1,0,6,0,-6
6084,1,0,13,0,-13
6085,1,0,2,0,-2
6086,1,0,60,0,-60
6087,0,0,70,0,-70
6088,0,0,0,0,0
6089,1,0,5,0,-5
6090,1,0,38,0,-38
6091,0,0,17,0,-17
6092,0,0,40,0,-40
6093,1,1,376,1608,1232
6094,1,0,87,0,-87
6095,0,0,117,0,-117
6096,1,1,2159,1242,-917
6097,1,1,147,1367,1220
6098,0,0,64,0,-64
6099,1,1,730,1647,917
6100,0,0,32,0,-32
6101,1,0,78,0,-78
6102,0,0,5,0,-5
6103,0,0,1,0,-1
6104,0,0,278,0,-278
6105,1,0,14,0,-14
6106,0,0,23,0,-23
6107,0,0,52,0,-52
6108,0,0,53,0,-53
6109,1,0,0,0,0
6110,0,0,17,0,-17
6111,0,0,62,0,-62
6112,1,0,25,0,-25
6113,0,0,68,0,-68
6114,1,0,11,0,-11
6115,0,0,67,0,-67
6116,0,0,15,0,-15
6117,1,0,94,0,-94
6118,1,0,220,0,-220
6119,0,0,7,0,-7
6120,1,1,112,2636,2524
6121,1,0,43,0,-43
6122,0,0,13,0,-13
6123,1,0,31,0,-31
6124,0,0,21,0,-21
6125,0,0,129,0,-129
6126,0,0,10,0,-10
6127,0,0,21,0,-21
6128,0,0,31,0,-31
6129,1,0,2,0,-2
6130,1,0,1,0,-1
6131,1,1,1634,1360,-274
6132,1,0,33,0,-33
6133,0,0,31,0,-31
6134,0,0,31,0,-31
6135,1,0,26,0,-26
6136,0,0,16,0,-16
6137,1,0,21,0,-21
6138,1,0,0,0,0
6139,0,0,86,0,-86
6140,1,1,256,1344,1088
6141,0,0,25,0,-25
6142,0,0,76,0,-76
6143,1,0,46,0,-46
6144,0,0,25,0,-25
6145,0,0,29,0,-29
6146,0,0,116,0,-116
6147,1,0,7,0,-7
6148,0,0,1,0,-1
6149,1,0,103,0,-103
6150,1,1,305,1515,1210
6151,0,0,6,0,-6
6152,0,0,80,0,-80
6153,0,0,31,0,-31
6154,1,1,547,1976,1429
6155,1,0,2,0,-2
6156,1,1,374,1264,890
6157,1,0,44,0,-44
6158,0,0,53,0,-53
6159,0,0,168,0,-168
6160,0,0,27,0,-27
6161,1,1,2073,1573,-500
6162,1,0,84,0,-84
6163,1,1,61,2125,2064
6164,1,1,88,1798,1710
6165,0,0,23,0,-23
6166,1,1,714,1377,663
6167,0,0,56,0,-56
6168,1,1,41,1409,1368
6169,1,0,76,0,-76
6170,0,0,255,0,-255
6171,1,1,632,1250,618
6172,1,0,136,0,-136
6173,0,0,2,0,-2
6174,0,0,28,0,-28
6175,0,0,72,0,-72
6176,0,0,55,0,-55
6177,0,0,103,0,-103
6178,1,0,62,0,-62
6179,1,1,1395,1255,-140
6180,1,0,5,0,-5
6181,0,0,77,0,-77
6182,0,0,19,0,-19
6183,0,0,38,0,-38
6184,1,1,2145,1237,-908
6185,0,0,48,0,-48
6186,1,1,446,4454,4008
6187,1,0,15,0,-15
6188,0,0,10,0,-10
6189,1,1,93,1453,1360
6190,1,0,54,0,-54
6191,1,1,143,1417,1274
6192,1,0,28,0,-28
6193,1,0,17,0,-17
6194,1,0,39,0,-39
6195,1,0,35,0,-35
6196,0,0,59,0,-59
6197,1,1,172,1404,1232
6198,0,0,24,0,-24
6199,1,0,64,0,-64
6200,0,0,9,0,-9
6201,1,1,64,1286,1222
6202,1,1,477,1391,914
6203,1,0,255,0,-255
6204,1,0,93,0,-93
6205,1,0,8,0,-8
6206,1,1,93,2807,2714
6207,0,0,2,0,-2
6208,1,0,146,0,-146
6209,1,1,40,1830,1790
6210,0,0,207,0,-207
6211,1,0,98,0,-98
6212,1,0,90,0,-90
6213,1,1,833,1233,400
6214,0,0,68,0,-68
6215,0,0,7,0,-7
6216,0,0,46,0,-46
6217,0,0,11,0,-11
6218,0,0,5,0,-5
6219,1,1,332,1219,887
6220,0,0,68,0,-68
6221,1,0,49,0,-49
6222,0,0,46,0,-46
6223,1,0,2,0,-2
6224,1,1,610,1306,696
6225,0,0,45,0,-45
6226,1,1,155,1577,1422
6227,1,1,750,1224,474
6228,1,0,149,0,-149
6229,0,0,45,0,-45
6230,0,0,4,0,-4
6231,1,1,170,1323,1153
6232,1,0,29,0,-29
6233,1,0,26,0,-26
6234,1,0,41,0,-41
6235,0,0,6,0,-6
6236,1,0,7,0,-7
6237,1,1,912,1256,344
6238,0,0,25,0,-25
6239,1,0,14,0,-14
6240,1,0,56,0,-56
6241,1,1,274,2370,2096
6242,1,0,9,0,-9
6243,0,0,92,0,-92
6244,1,0,46,0,-46
6245,1,1,527,1395,868
6246,1,1,3955,1370,-2585
6247,0,0,26,0,-26
6248,0,0,27,0,-27
6249,0,0,4,0,-4
6250,0,0,20,0,-20
6251,1,1,971,1706,735
6252,1,0,0,0,0
6253,1,0,20,0,-20
6254,1,1,537,1267,730
6255,0,0,28,0,-28
6256,1,0,31,0,-31
6257,1,0,55,0,-55
6258,1,0,1,0,-1
6259,1,1,597,1277,680
6260,1,1,1130,1534,404
6261,1,0,83,0,-83
6262,0,0,15,0,-15
6263,1,0,28,0,-28
6264,1,1,99,1229,1130
6265,0,0,36,0,-36
6266,1,0,37,0,-37
6267,1,1,1326,1821,495
6268,0,0,28,0,-28
6269,0,0,45,0,-45
6270,0,0,17,0,-17
6271,0,0,128,0,-128
6272,0,0,25,0,-25
6273,0,0,73,0,-73
6274,0,0,23,0,-23
6275,0,0,22,0,-22
6276,1,1,329,1589,1260
6277,0,0,221,0,-221
6278,1,1,1023,1879,856
6279,1,1,631,1209,578
6280,0,0,15,0,-15
6281,0,0,70,0,-70
6282,1,0,8,0,-8
6283,1,0,25,0,-25
6284,0,0,6,0,-6
6285,0,0,34,0,-34
6286,0,0,25,0,-25
6287,0,0,222,0,-222
6288,0,0,37,0,-37
6289,1,0,18,0,-18
6290,0,0,31,0,-31
6291,0,0,58,0,-58
6292,1,1,75,1258,1183
6293,1,0,26,0,-26
6294,1,1,210,1247,1037
6295,1,1,566,1896,1330
6296,0,0,26,0,-26
6297,1,1,914,1419,505
6298,1,1,161,1659,1498
6299,1,0,42,0,-42
6300,0,0,19,0,-19
6301,1,0,68,0,-68
6302,0,0,60,0,-60
6303,1,1,158,1379,1221
6304,0,0,106,0,-106
6305,0,0,16,0,-16
6306,1,0,41,0,-41
6307,1,0,89,0,-89
6308,0,0,100,0,-100
6309,1,1,237,1207,970
6310,1,1,194,1248,1054
6311,0,0,58,0,-58
6312,0,0,27,0,-27
6313,0,0,24,0,-24
6314,0,0,2,0,-2
6315,0,0,9,0,-9
6316,1,1,183,4294,4111
6317,1,1,861,2734,1873
6318,0,0,21,0,-21
6319,0,0,34,0,-34
6320,1,1,172,1432,1260
6321,1,0,49,0,-49
6322,0,0,23,0,-23
6323,1,1,3458,1389,-2069
6324,0,0,21,0,-21
6325,1,0,29,0,-29
6326,1,1,272,1520,1248
6327,0,0,133,0,-133
6328,1,1,213,1939,1726
6329,0,0,99,0,-99
6330,1,1,546,2017,1471
6331,1,1,119,2951,2832
6332,1,1,646,1464,818
6333,1,1,92,2080,1988
6334,1,0,70,0,-70
6335,1,0,45,0,-45
6336,0,0,27,0,-27
6337,0,0,12,0,-12
6338,1,1,683,2096,1413
6339,0,0,10,0,-10
6340,0,0,15,0,-15
6341,0,0,39,0,-39
6342,1,1,814,2429,1615
6343,1,1,70,1394,1324
6344,1,1,379,1221,842
6345,1,0,71,0,-71
6346,1,1,1423,1268,-155
6347,0,0,94,0,-94
6348,1,1,129,1221,1092
6349,1,0,79,0,-79
6350,0,0,9,0,-9
6351,1,1,104,1627,1523
6352,1,1,99,1369,1270
6353,0,0,132,0,-132
6354,1,1,182,1806,1624
6355,1,0,37,0,-37
6356,0,0,49,0,-49
6357,0,0,164,0,-164
6358,1,1,972,1744,772
6359,0,0,18,0,-18
6360,1,0,75,0,-75
6361,1,0,98,0,-98
6362,1,0,45,0,-45
6363,0,0,38,0,-38
6364,1,0,24,0,-24
6365,0,0,62,0,-62
6366,1,0,15,0,-15
6367,1,0,31,0,-31
6368,0,0,51,0,-51
6369,1,1,1011,1236,225
6370,1,1,459,1428,969
6371,0,0,9,0,-9
6372,1,0,8,0,-8
6373,1,1,385,1498,1113
6374,1,1,794,1727,933
6375,1,1,194,2192,1998
6376,1,0,51,0,-51
6377,0,0,16,0,-16
6378,0,0,60,0,-60
6379,1,1,1869,1516,-353
6380,1,0,132,0,-132
6381,0,0,72,0,-72
6382,0,0,91,0,-91
6383,1,1,1008,1327,319
6384,0,0,4,0,-4
6385,1,1,54,1488,1434
6386,0,0,34,0,-34
6387,1,1,1442,1710,268
6388,0,0,4,0,-4
6389,1,0,79,0,-79
6390,0,0,32,0,-32
6391,0,0,75,0,-75
6392,1,1,450,1258,808
6393,1,1,772,1650,878
6394,0,0,2,0,-2
6395,1,1,1828,2033,205
6396,1,0,35,0,-35
6397,0,0,4,0,-4
6398,1,0,23,0,-23
6399,1,0,73,0,-73
6400,0,0,3,0,-3
6401,1,0,80,0,-80
6402,1,0,28,0,-28
6403,0,0,57,0,-57
6404,0,0,18,0,-18
6405,1,0,49,0,-49
6406,1,0,35,0,-35
6407,1,0,23,0,-23
6408,1,1,193,1204,1011
6409,0,0,17,0,-17
6410,0,0,3,0,-3
6411,1,1,448,1235,787
6412,0,0,6,0,-6
6413,1,0,9,0,-9
6414,1,0,18,0,-18
6415,1,0,30,0,-30
6416,1,1,586,1440,854
6417,0,0,40,0,-40
6418,0,0,96,0,-96
6419,1,0,50,0,-50
6420,1,0,87,0,-87
6421,1,0,79,0,-79
6422,0,0,11,0,-11
6423,1,1,425,1234,809
6424,0,0,8,0,-8
6425,1,0,56,0,-56
6426,1,0,151,0,-151
6427,1,1,584,1335,751
6428,1,1,461,1777,1316
6429,0,0,24,0,-24
6430,1,1,236,1963,1727
6431,0,0,23,0,-23
6432,1,0,116,0,-116
6433,0,0,248,0,-248
6434,0,0,16,0,-16
6435,1,0,17,0,-17
6436,0,0,0,0,0
6437,1,0,114,0,-114
6438,1,0,37,0,-37
6439,0,0,5,0,-5
6440,0,0,28,0,-28
6441,1,0,11,0,-11
6442,1,0,145,0,-145
6443,1,1,507,1662,1155
6444,0,0,10,0,-10
6445,1,1,976,1381,405
6446,1,1,317,1520,1203
6447,0,0,46,0,-46
6448,1,0,8,0,-8
6449,0,0,31,0,-31
6450,1,0,41,0,-41
6451,1,0,89,0,-89
6452,1,1,395,1232,837
6453,1,1,528,1492,964
6454,1,0,54,0,-54
6455,0,0,66,0,-66
6456,1,1,39,2856,2817
6457,1,1,857,1455,598
6458,1,0,12,0,-12
6459,1,1,539,1238,699
6460,1,1,812,1273,461
6461,0,0,20,0,-20
6462,1,1,308,1292,984
6463,1,1,513,1550,1037
6464,0,0,50,0,-50
6465,1,1,109,1272,1163
6466,1,1,304,1298,994
6467,1,1,222,1644,1422
6468,0,0,65,0,-65
6469,1,1,706,1860,1154
6470,0,0,9,0,-9
6471,1,1,21,2023,2002
6472,0,0,25,0,-25
6473,1,0,75,0,-75
6474,1,0,5,0,-5
6475,0,0,20,0,-20
6476,1,1,660,1296,636
6477,0,0,0,0,0
6478,1,0,53,0,-53
6479,1,0,17,0,-17
6480,1,0,182,0,-182
6481,1,1,349,1449,1100
6482,1,1,262,1422,1160
6483,0,0,27,0,-27
6484,1,0,12,0,-12
6485,1,0,113,0,-113
6486,0,0,63,0,-63
6487,1,0,63,0,-63
6488,1,0,25,0,-25
6489,1,1,329,1837,1508
6490,0,0,28,0,-28
6491,0,0,31,0,-31
6492,0,0,16,0,-16
6493,1,1,47,2099,2052
6494,1,0,84,0,-84
6495,1,1,1161,1641,480
6496,1,0,2,0,-2
6497,1,0,58,0,-58
6498,0,0,19,0,-19
6499,0,0,73,0,-73
6500,0,0,28,0,-28
6501,1,1,364,1285,921
6502,1,0,7,0,-7
6503,1,1,297,1546,1249
6504,1,0,58,0,-58
6505,1,1,906,1254,348
6506,1,1,842,1551,709
6507,1,1,119,1730,1611
6508,1,1,813,2346,1533
6509,1,0,10,0,-10
6510,1,1,427,1232,805
6511,0,0,51,0,-51
6512,0,0,33,0,-33
6513,1,1,513,1623,1110
6514,0,0,22,0,-22
6515,1,1,162,1616,1454
6516,0,0,23,0,-23
6517,1,0,66,0,-66
6518,1,0,30,0,-30
6519,1,1,556,1273,717
6520,1,0,29,0,-29
6521,1,1,1226,1761,535
6522,0,0,3,0,-3
6523,1,0,20,0,-20
6524,1,0,73,0,-73
6525,0,0,4,0,-4
6526,0,0,27,0,-27
6527,0,0,21,0,-21
6528,0,0,1,0,-1
6529,1,1,38,1681,1643
6530,0,0,35,0,-35
6531,1,0,16,0,-16
6532,1,1,227,1572,1345
6533,0,0,71,0,-71
6534,0,0,19,0,-19
6535,1,1,379,1456,1077
6536,1,1,57,1893,1836
6537,1,1,1153,1235,82
6538,1,1,103,1493,1390
6539,1,0,17,0,-17
6540,1,1,974,2251,1277
6541,1,0,16,0,-16
6542,1,0,26,0,-26
6543,0,0,22,0,-22
6544,1,0,82,0,-82
6545,1,1,1388,1495,107
6546,0,0,80,0,-80
6547,0,0,70,0,-70
6548,1,1,1246,1334,88
6549,1,0,8,0,-8
6550,1,1,937,1656,719
6551,1,0,93,0,-93
6552,1,1,234,1542,1308
6553,0,0,134,0,-134
6554,1,1,636,1315,679
6555,1,0,49,0,-49
6556,0,0,45,0,-45
6557,1,0,28,0,-28
6558,1,1,394,1334,940
6559,1,1,406,2050,1644
6560,1,1,161,1756,1595
6561,0,0,42,0,-42
6562,1,1,417,1974,1557
6563,1,1,1120,1352,232
6564,1,1,142,1259,1117
6565,1,1,1254,1214,-40
6566,1,1,96,1941,1845
6567,1,1,265,1722,1457
6568,1,0,0,0,0
6569,1,1,237,1870,1633
6570,0,0,97,0,-97
6571,0,0,91,0,-91
6572,1,1,572,1394,822
6573,1,1,1709,1480,-229
6574,1,0,256,0,-256
6575,1,1,1213,1643,430
6576,1,0,36,0,-36
6577,1,1,326,1494,1168
6578,0,0,77,0,-77
6579,1,0,9,0,-9
6580,0,0,38,0,-38
6581,0,0,160,0,-160
6582,0,0,8,0,-8
6583,1,0,2,0,-2
6584,1,1,390,1998,1608
6585,1,1,778,1236,458
6586,1,0,105,0,-105
6587,1,0,106,0,-106
6588,0,0,41,0,-41
6589,0,0,29,0,-29
6590,1,1,227,1625,1398
6591,0,0,98,0,-98
6592,1,0,42,0,-42
6593,1,0,8,0,-8
6594,1,1,1146,2167,1021
6595,0,0,19,0,-19
6596,0,0,108,0,-108
6597,1,1,347,1604,1257
6598,1,0,24,0,-24
6599,1,1,1169,1265,96
6600,0,0,76,0,-76
6601,0,0,31,0,-31
6602,0,0,58,0,-58
6603,1,0,2,0,-2
6604,0,0,101,0,-101
6605,0,0,27,0,-27
6606,0,0,15,0,-15
6607,0,0,42,0,-42
6608,1,1,284,1328,1044
6609,0,0,46,0,-46
6610,1,1,97,1235,1138
6611,0,0,47,0,-47
6612,1,0,9,0,-9
6613,0,0,27,0,-27
6614,1,0,105,0,-105
6615,1,1,27,1259,1232
6616,1,0,42,0,-42
6617,1,0,16,0,-16
6618,1,1,97,1681,1584
6619,0,0,26,0,-26
6620,0,0,35,0,-35
6621,1,0,14,0,-14
6622,1,1,1146,1515,369
6623,1,1,878,1318,440
6624,1,0,35,0,-35
6625,1,1,126,1308,1182
6626,1,1,871,2130,1259
6627,1,1,295,1628,1333
6628,1,0,93,0,-93
6629,0,0,36,0,-36
6630,0,0,2,0,-2
6631,0,0,26,0,-26
6632,1,0,15,0,-15
6633,1,1,361,2322,1961
6634,1,0,36,0,-36
6635,1,0,4,0,-4
6636,1,0,37,0,-37
6637,1,0,73,0,-73
6638,1,1,199,1303,1104
6639,1,0,31,0,-31
6640,0,0,25,0,-25
6641,1,1,1282,1500,218
6642,0,0,23,0,-23
6643,1,0,2,0,-2
6644,1,0,43,0,-43
6645,1,0,12,0,-12
6646,0,0,66,0,-66
6647,1,1,1824,1973,149
6648,1,1,1935,1294,-641
6649,0,0,147,0,-147
6650,1,0,45,0,-45
6651,1,0,88,0,-88
6652,1,1,299,1525,1226
6653,0,0,40,0,-40
6654,1,0,10,0,-10
6655,1,1,1070,2811,1741
6656,0,0,17,0,-17
6657,1,0,33,0,-33
6658,1,0,41,0,-41
6659,1,1,31,1527,1496
6660,0,0,1,0,-1
6661,0,0,36,0,-36
6662,1,1,143,1650,1507
6663,1,0,8,0,-8
6664,1,1,1032,1356,324
6665,1,1,587,1369,782
6666,1,0,0,0,0
6667,1,0,125,0,-125
6668,1,0,36,0,-36
6669,0,0,35,0,-35
6670,0,0,1,0,-1
6671,0,0,96,0,-96
6672,1,1,90,2077,1987
6673,0,0,26,0,-26
6674,0,0,16,0,-16
6675,1,1,618,1719,1101
6676,0,0,11,0,-11
6677,1,0,103,0,-103
6678,1,1,454,1487,1033
6679,0,0,3,0,-3
6680,1,1,673,1312,639
6681,0,0,245,0,-245
6682,1,1,1104,1255,151
6683,1,1,701,1296,595
6684,0,0,225,0,-225
6685,1,0,59,0,-59
6686,1,0,61,0,-61
6687,1,0,54,0,-54
6688,0,0,56,0,-56
6689,1,0,19,0,-19
6690,0,0,16,0,-16
6691,1,0,90,0,-90
6692,1,1,2013,1310,-703
6693,1,1,302,1750,1448
6694,1,0,5,0,-5
6695,0,0,56,0,-56
6696,1,0,6,0,-6
6697,1,0,46,0,-46
6698,1,1,589,1348,759
6699,0,0,90,0,-90
6700,0,0,72,0,-72
6701,0,0,8,0,-8
6702,1,1,249,1284,1035
6703,1,0,8,0,-8
6704,0,0,44,0,-44
6705,1,0,12,0,-12
6706,1,1,645,1534,889
6707,0,0,37,0,-37
6708,1,0,19,0,-19
6709,0,0,13,0,-13
6710,1,0,19,0,-19
6711,0,0,137,0,-137
6712,1,1,82,1400,1318
6713,0,0,0,0,0
6714,1,1,237,1380,1143
6715,1,1,558,1203,645
6716,0,0,12,0,-12
6717,1,0,24,0,-24
6718,1,0,12,0,-12
6719,0,0,23,0,-23
6720,0,0,30,0,-30
6721,1,0,30,0,-30
6722,0,0,84,0,-84
6723,0,0,7,0,-7
6724,0,0,15,0,-15
6725,1,1,60,1225,1165
6726,1,0,2,0,-2
6727,1,0,92,0,-92
6728,0,0,135,0,-135
6729,1,0,7,0,-7
6730,0,0,3,0,-3
6731,0,0,16,0,-16
6732,1,0,101,0,-101
6733,1,1,505,1421,916
6734,0,0,117,0,-117
6735,1,0,41,0,-41
6736,1,0,19,0,-19
6737,1,1,698,1267,569
6738,1,0,5,0,-5
6739,0,0,9,0,-9
6740,1,1,263,1367,1104
6741,1,0,6,0,-6
6742,0,0,54,0,-54
6743,1,0,20,0,-20
6744,0,0,53,0,-53
6745,0,0,3,0,-3
6746,0,0,41,0,-41
6747,1,0,7,0,-7
6748,1,0,72,0,-72
6749,1,0,16,0,-16
6750,1,1,670,1891,1221
6751,0,0,58,0,-58
6752,1,0,101,0,-101
6753,0,0,24,0,-24
6754,1,1,448,1912,1464
6755,1,0,9,0,-9
6756,0,0,36,0,-36
6757,1,0,46,0,-46
6758,1,0,11,0,-11
6759,1,1,61,1560,1499
6760,0,0,2,0,-2
6761,1,0,46,0,-46
6762,1,0,11,0,-11
6763,0,0,87,0,-87
6764,0,0,81,0,-81
6765,0,0,90,0,-90
6766,1,1,502,1490,988
6767,1,1,600,1283,683
6768,1,0,120,0,-120
6769,0,0,7,0,-7
6770,1,0,42,0,-42
6771,1,1,235,1207,972
6772,1,1,675,1859,1184
6773,1,1,682,1214,532
6774,1,0,109,0,-109
6775,0,0,66,0,-66
6776,1,1,2663,1574,-1089
6777,1,0,12,0,-12
6778,1,0,17,0,-17
6779,1,0,72,0,-72
6780,1,0,9,0,-9
6781,1,1,686,1469,783
6782,1,1,440,2122,1682
6783,0,0,7,0,-7
6784,1,0,42,0,-42
6785,1,1,277,1330,1053
6786,0,0,0,0,0
6787,0,0,80,0,-80
6788,0,0,1,0,-1
6789,1,0,74,0,-74
6790,0,0,47,0,-47
6791,0,0,6,0,-6
6792,0,0,10,0,-10
6793,1,0,83,0,-83
6794,0,0,2,0,-2
6795,1,1,434,1671,1237
6796,1,1,108,1275,1167
6797,1,0,108,0,-108
6798,1,0,23,0,-23
6799,1,0,61,0,-61
6800,0,0,1,0,-1
6801,0,0,4,0,-4
6802,1,1,463,1685,1222
6803,0,0,82,0,-82
6804,0,0,111,0,-111
6805,1,0,49,0,-49
6806,1,0,112,0,-112
6807,1,0,53,0,-53
6808,0,0,13,0,-13
6809,1,0,24,0,-24
6810,0,0,101,0,-101
6811,1,1,165,1493,1328
6812,1,0,23,0,-23
6813,1,0,1,0,-1
6814,0,0,109,0,-109
6815,1,1,742,1270,528
6816,1,0,87,0,-87
6817,1,1,250,2313,2063
6818,0,0,28,0,-28
6819,1,0,58,0,-58
6820,0,0,49,0,-49
6821,1,0,85,0,-85
6822,1,1,324,3299,2975
6823,0,0,27,0,-27
6824,1,0,30,0,-30
6825,0,0,341,0,-341
6826,1,0,144,0,-144
6827,1,1,246,1353,1107
6828,1,0,22,0,-22
6829,1,0,29,0,-29
6830,1,0,2,0,-2
6831,0,0,33,0,-33
6832,1,0,42,0,-42
6833,0,0,31,0,-31
6834,1,1,257,1427,1170
6835,1,1,234,1315,1081
6836,0,0,20,0,-20
6837,1,0,21,0,-21
6838,0,0,0,0,0
6839,1,1,2117,1224,-893
6840,0,0,52,0,-52
6841,0,0,78,0,-78
6842,0,0,76,0,-76
6843,0,0,28,0,-28
6844,0,0,80,0,-80
6845,1,0,67,0,-67
6846,1,0,24,0,-24
6847,1,1,334,1922,1588
6848,0,0,19,0,-19
6849,0,0,136,0,-136
6850,0,0,8,0,-8
6851,0,0,15,0,-15
6852,0,0,32,0,-32
6853,0,0,48,0,-48
6854,0,0,27,0,-27
6855,1,0,3,0,-3
6856,1,0,117,0,-117
6857,1,1,744,1353,609
6858,0,0,16,0,-16
6859,1,1,1342,1280,-62
6860,1,1,370,1333,963
6861,1,0,18,0,-18
6862,0,0,28,0,-28
6863,1,0,68,0,-68
6864,0,0,80,0,-80
6865,0,0,1,0,-1
6866,1,1,343,1337,994
6867,1,1,309,1209,900
6868,0,0,50,0,-50
6869,0,0,56,0,-56
6870,0,0,97,0,-97
6871,0,0,122,0,-122
6872,1,0,23,0,-23
6873,1,1,60,1505,1445
6874,1,1,321,1281,960
6875,0,0,43,0,-43
6876,0,0,47,0,-47
6877,1,1,1386,1520,134
6878,0,0,13,0,-13
6879,1,1,501,1410,909
6880,1,1,248,2397,2149
6881,0,0,17,0,-17
6882,0,0,124,0,-124
6883,1,1,870,1254,384
6884,1,0,18,0,-18
6885,0,0,35,0,-35
6886,1,0,58,0,-58
6887,0,0,70,0,-70
6888,0,0,10,0,-10
6889,1,1,370,1247,877
6890,0,0,11,0,-11
6891,1,1,1293,1402,109
6892,1,1,127,1922,1795
6893,0,0,20,0,-20
6894,1,1,1264,1240,-24
6895,1,1,319,1811,1492
6896,1,0,88,0,-88
6897,0,0,20,0,-20
6898,1,1,329,1405,1076
6899,0,0,101,0,-101
6900,1,0,88,0,-88
6901,0,0,67,0,-67
6902,0,0,113,0,-113
6903,0,0,14,0,-14
6904,1,0,33,0,-33
6905,1,0,77,0,-77
6906,0,0,51,0,-51
6907,1,0,103,0,-103
6908,0,0,98,0,-98
6909,1,0,156,0,-156
6910,1,1,193,1490,1297
6911,1,1,1292,1368,76
6912,0,0,21,0,-21
6913,0,0,4,0,-4
6914,1,0,64,0,-64
6915,0,0,37,0,-37
6916,1,0,52,0,-52
6917,1,1,1536,2040,504
6918,1,0,58,0,-58
6919,1,0,59,0,-59
6920,1,1,352,1300,948
6921,0,0,32,0,-32
6922,0,0,83,0,-83
6923,0,0,12,0,-12
6924,1,0,89,0,-89
6925,0,0,136,0,-136
6926,0,0,12,0,-12
6927,0,0,173,0,-173
6928,1,0,2,0,-2
6929,0,0,55,0,-55
6930,0,0,12,0,-12
6931,1,1,1028,1316,288
6932,1,0,21,0,-21
6933,0,0,33,0,-33
6934,0,0,88,0,-88
6935,1,0,19,0,-19
6936,0,0,188,0,-188
6937,1,1,683,1744,1061
6938,0,0,92,0,-92
6939,0,0,3,0,-3
6940,1,0,47,0,-47
6941,0,0,155,0,-155
6942,1,1,357,1326,969
6943,1,1,244,1212,968
6944,0,0,2,0,-2
6945,0,0,5,0,-5
6946,1,0,5,0,-5
6947,1,0,12,0,-12
6948,0,0,33,0,-33
6949,0,0,42,0,-42
6950,1,1,880,1254,374
6951,1,0,16,0,-16
6952,0,0,41,0,-41
6953,1,1,1193,1438,245
6954,1,1,32,1389,1357
6955,0,0,62,0,-62
6956,0,0,25,0,-25
6957,0,0,97,0,-97
6958,0,0,33,0,-33
6959,0,0,45,0,-45
6960,1,0,36,0,-36
6961,1,0,9,0,-9
6962,1,1,670,3876,3206
6963,1,1,783,1228,445
6964,0,0,0,0,0
6965,0,0,38,0,-38
6966,1,1,268,1398,1130
6967,0,0,51,0,-51
6968,0,0,73,0,-73
6969,0,0,263,0,-263
6970,0,0,33,0,-33
6971,1,0,3,0,-3
6972,0,0,39,0,-39
6973,1,1,1046,1323,277
6974,1,0,56,0,-56
6975,1,0,49,0,-49
6976,1,1,1167,1435,268
6977,1,1,413,1620,1207
6978,0,0,28,0,-28
6979,1,1,261,2569,2308
6980,0,0,76,0,-76
6981,0,0,32,0,-32
6982,0,0,116,0,-116
6983,0,0,5,0,-5
6984,1,0,15,0,-15
6985,0,0,50,0,-50
6986,0,0,31,0,-31
6987,1,1,346,2080,1734
6988,1,0,2,0,-2
6989,1,0,28,0,-28
6990,1,1,134,1340,1206
6991,1,0,80,0,-80
6992,1,0,1,0,-1
6993,0,0,44,0,-44
6994,1,0,11,0,-11
6995,1,0,26,0,-26
6996,0,0,46,0,-46
6997,1,1,319,3224,2905
6998,1,1,508,1902,1394
6999,1,0,185,0,-185
7000,1,1,473,1565,1092
7001,1,1,154,1276,1122
7002,1,1,507,2006,1499
7003,0,0,49,0,-49
7004,1,1,448,1235,787
7005,0,0,9,0,-9
7006,0,0,26,0,-26
7007,0,0,15,0,-15
7008,0,0,40,0,-40
7009,1,0,160,0,-160
7010,1,1,1705,1719,14
7011,1,0,45,0,-45
7012,0,0,7,0,-7
7013,1,0,188,0,-188
7014,0,0,151,0,-151
7015,0,0,26,0,-26
7016,1,0,9,0,-9
7017,0,0,62,0,-62
7018,1,0,0,0,0
7019,1,1,117,1217,1100
7020,0,0,75,0,-75
7021,0,0,43,0,-43
7022,0,0,13,0,-13
7023,1,0,69,0,-69
7024,1,0,2,0,-2
7025,0,0,51,0,-51
7026,1,0,45,0,-45
7027,0,0,38,0,-38
7028,1,1,516,1426,910
7029,0,0,73,0,-73
7030,1,0,7,0,-7
7031,0,0,17,0,-17
7032,0,0,51,0,-51
7033,0,0,11,0,-11
7034,0,0,6,0,-6
7035,0,0,53,0,-53
7036,1,1,42,1689,1647
7037,0,0,34,0,-34
7038,0,0,43,0,-43
7039,0,0,78,0,-78
7040,1,1,141,1304,1163
7041,1,1,256,1297,1041
7042,0,0,8,0,-8
7043,1,1,232,1238,1006
7044,0,0,0,0,0
7045,1,0,394,0,-394
7046,1,0,25,0,-25
7047,0,0,53,0,-53
7048,0,0,123,0,-123
7049,1,1,401,1531,1130
7050,0,0,5,0,-5
7051,0,0,138,0,-138
7052,1,0,39,0,-39
7053,1,0,7,0,-7
7054,1,0,142,0,-142
7055,1,0,53,0,-53
7056,1,0,128,0,-128
7057,1,1,1857,1292,-565
7058,1,0,128,0,-128
7059,0,0,12,0,-12
7060,1,0,22,0,-22
7061,1,1,446,1202,756
7062,0,0,107,0,-107
7063,0,0,99,0,-99
7064,0,0,38,0,-38
7065,1,0,22,0,-22
7066,1,1,342,1324,982
7067,1,0,7,0,-7
7068,1,0,32,0,-32
7069,0,0,6,0,-6
7070,1,0,100,0,-100
7071,1,0,36,0,-36
7072,0,0,163,0,-163
7073,1,0,20,0,-20
7074,1,1,536,1348,812
7075,0,0,41,0,-41
7076,0,0,191,0,-191
7077,0,0,15,0,-15
7078,1,1,29,1267,1238
7079,1,1,46,1617,1571
7080,1,1,679,1310,631
7081,0,0,15,0,-15
7082,1,0,20,0,-20
7083,1,1,39,1635,1596
7084,1,0,5,0,-5
7085,0,0,7,0,-7
7086,0,0,70,0,-70
7087,1,1,335,1524,1189
7088,1,1,214,1233,1019
7089,1,1,232,1253,1021
7090,0,0,90,0,-90
7091,0,0,48,0,-48
7092,0,0,119,0,-119
7093,1,0,68,0,-68
7094,1,0,18,0,-18
7095,1,0,155,0,-155
7096,0,0,37,0,-37
7097,0,0,21,0,-21
7098,1,0,43,0,-43
7099,1,0,170,0,-170
7100,1,1,830,1209,379
7101,1,0,6,0,-6
7102,0,0,84,0,-84
7103,0,0,34,0,-34
7104,1,0,13,0,-13
7105,1,0,37,0,-37
7106,0,0,0,0,0
7107,0,0,9,0,-9
7108,0,0,1,0,-1
7109,0,0,19,0,-19
7110,1,1,405,2530,2125
7111,0,0,10,0,-10
7112,1,0,66,0,-66
7113,1,1,62,1201,1139
7114,1,1,237,3241,3004
7115,1,0,20,0,-20
7116,1,0,1,0,-1
7117,1,0,78,0,-78
7118,1,1,401,1306,905
7119,1,0,64,0,-64
7120,0,0,22,0,-22
7121,1,1,368,1281,913
7122,1,1,414,1772,1358
7123,1,1,82,1392,1310
7124,1,1,315,1207,892
7125,1,1,194,1241,1047
7126,1,0,48,0,-48
7127,1,0,62,0,-62
7128,0,0,115,0,-115
7129,0,0,13,0,-13
7130,0,0,30,0,-30
7131,1,1,521,1420,899
7132,0,0,6,0,-6
7133,1,0,32,0,-32
7134,1,1,592,1394,802
7135,0,0,55,0,-55
7136,1,1,940,1212,272
7137,1,1,502,2774,2272
7138,1,1,437,1257,820
7139,1,0,62,0,-62
7140,0,0,17,0,-17
7141,0,0,48,0,-48
7142,1,0,11,0,-11
7143,1,0,7,0,-7
7144,0,0,15,0,-15
7145,1,1,142,1217,1075
7146,1,0,2,0,-2
7147,0,0,0,0,0
7148,0,0,1,0,-1
7149,1,1,698,1330,632
7150,1,1,1336,1417,81
7151,1,1,231,1201,970
7152,1,1,452,1216,764
7153,1,1,224,1627,1403
7154,1,1,292,1248,956
7155,1,1,94,1334,1240
7156,1,1,332,1393,1061
7157,1,0,51,0,-51
7158,0,0,60,0,-60
7159,1,0,55,0,-55
7160,1,1,535,1407,872
7161,1,0,79,0,-79
7162,1,1,1043,2175,1132
7163,0,0,50,0,-50
7164,1,1,920,1322,402
7165,1,0,112,0,-112
7166,0,0,63,0,-63
7167,0,0,1,0,-1
7168,1,0,39,0,-39
7169,1,0,180,0,-180
7170,1,1,67,1423,1356
7171,0,0,36,0,-36
7172,1,1,277,1388,1111
7173,0,0,44,0,-44
7174,1,1,372,1507,1135
7175,1,1,743,1382,639
7176,1,1,777,1875,1098
7177,0,0,44,0,-44
7178,1,1,67,1374,1307
7179,0,0,153,0,-153
7180,1,1,697,1412,715
7181,0,0,56,0,-56
7182,1,1,1145,1317,172
7183,1,1,640,1624,984
7184,1,1,350,1322,972
7185,1,0,5,0,-5
7186,0,0,33,0,-33
7187,0,0,215,0,-215
7188,0,0,71,0,-71
7189,0,0,25,0,-25
7190,1,1,137,1419,1282
7191,0,0,12,0,-12
7192,0,0,12,0,-12
7193,0,0,118,0,-118
7194,1,0,68,0,-68
7195,1,0,91,0,-91
7196,1,1,875,1283,408
7197,0,0,73,0,-73
7198,1,1,1062,3288,2226
7199,1,1,612,1735,1123
7200,1,1,475,1273,798
7201,0,0,9,0,-9
7202,1,0,70,0,-70
7203,0,0,49,0,-49
7204,1,0,26,0,-26
7205,0,0,32,0,-32
7206,0,0,38,0,-38
7207,1,0,15,0,-15
7208,0,0,36,0,-36
7209,0,0,54,0,-54
7210,0,0,61,0,-61
7211,0,0,61,0,-61
7212,0,0,45,0,-45
7213,0,0,49,0,-49
7214,0,0,18,0,-18
7215,1,1,1262,1215,-47
7216,1,1,1479,2255,776
7217,1,0,45,0,-45
7218,0,0,29,0,-29
7219,1,1,417,1922,1505
7220,1,1,527,1244,717
7221,0,0,192,0,-192
7222,0,0,18,0,-18
7223,0,0,20,0,-20
7224,1,0,61,0,-61
7225,1,1,152,1467,1315
7226,1,0,60,0,-60
7227,0,0,31,0,-31
7228,1,1,330,1515,1185
7229,1,1,351,1705,1354
7230,0,0,198,0,-198
7231,1,1,438,1383,945
7232,0,0,62,0,-62
7233,1,1,408,1302,894
7234,0,0,21,0,-21
7235,0,0,10,0,-10
7236,0,0,21,0,-21
7237,1,0,79,0,-79
7238,1,0,22,0,-22
7239,1,1,127,1324,1197
7240,0,0,61,0,-61
7241,1,1,74,1407,1333
7242,0,0,26,0,-26
7243,0,0,22,0,-22
7244,1,1,768,1383,615
7245,1,0,32,0,-32
7246,0,0,34,0,-34
7247,1,1,91,1299,1208
7248,1,1,116,1715,1599
7249,0,0,76,0,-76
7250,0,0,22,0,-22
7251,1,1,65,1216,1151
7252,0,0,19,0,-19
7253,0,0,0,0,0
7254,0,0,126,0,-126
7255,1,1,194,1485,1291
7256,0,0,120,0,-120
7257,1,1,170,1294,1124
7258,1,1,542,1255,713
7259,1,1,88,2107,2019
7260,0,0,179,0,-179
7261,0,0,10,0,-10
7262,1,0,37,0,-37
7263,1,0,40,0,-40
7264,0,0,18,0,-18
7265,1,1,177,1427,1250
7266,0,0,49,0,-49
7267,0,0,4,0,-4
7268,1,1,989,1464,475
7269,1,1,678,1443,765
7270,1,1,432,1375,943
7271,0,0,62,0,-62
7272,1,1,536,1413,877
7273,0,0,10,0,-10
7274,0,0,36,0,-36
7275,1,0,120,0,-120
7276,1,0,11,0,-11
7277,1,1,307,1617,1310
7278,1,0,34,0,-34
7279,0,0,95,0,-95
7280,1,1,816,1283,467
7281,0,0,9,0,-9
7282,1,0,12,0,-12
7283,0,0,28,0,-28
7284,1,1,207,1403,1196
7285,1,1,777,1384,607
7286,1,0,23,0,-23
7287,1,1,365,1260,895
7288,0,0,4,0,-4
7289,1,1,225,1245,1020
7290,1,1,788,1714,926
7291,0,0,108,0,-108
7292,0,0,78,0,-78
7293,1,1,402,1777,1375
7294,0,0,11,0,-11
7295,1,0,36,0,-36
7296,1,1,111,1438,1327
7297,0,0,4,0,-4
7298,0,0,42,0,-42
7299,0,0,112,0,-112
7300,1,0,1,0,-1
7301,1,0,17,0,-17
7302,1,0,1,0,-1
7303,1,0,1,0,-1
7304,0,0,188,0,-188
7305,1,1,147,1656,1509
7306,0,0,22,0,-22
7307,1,0,74,0,-74
7308,1,0,61,0,-61
7309,1,0,10,0,-10
7310,1,1,183,1992,1809
7311,1,1,446,2075,1629
7312,0,0,19,0,-19
7313,1,1,421,1258,837
7314,1,0,49,0,-49
7315,0,0,6,0,-6
7316,0,0,63,0,-63
7317,0,0,18,0,-18
7318,1,1,29,1988,1959
7319,0,0,230,0,-230
7320,1,0,82,0,-82
7321,1,1,334,1560,1226
7322,1,1,243,1596,1353
7323,1,1,347,1377,1030
7324,1,1,745,1780,1035
7325,1,0,49,0,-49
7326,0,0,40,0,-40
7327,1,1,1097,1570,473
7328,0,0,25,0,-25
7329,1,1,84,1809,1725
7330,0,0,38,0,-38
7331,0,0,1,0,-1
7332,0,0,198,0,-198
7333,0,0,20,0,-20
7334,0,0,86,0,-86
7335,1,1,469,1292,823
7336,1,1,245,1702,1457
7337,1,0,8,0,-8
7338,1,0,7,0,-7
7339,1,0,17,0,-17
7340,0,0,29,0,-29
7341,0,0,157,0,-157
7342,1,1,13,2927,2914
7343,1,1,3256,1610,-1646
7344,0,0,89,0,-89
7345,1,1,749,1353,604
7346,0,0,19,0,-19
7347,0,0,80,0,-80
7348,1,1,223,1221,998
7349,1,1,72,1797,1725
7350,1,1,438,1317,879
7351,1,1,170,1422,1252
7352,1,0,2,0,-2
7353,1,1,622,2024,1402
7354,0,0,164,0,-164
7355,1,0,13,0,-13
7356,0,0,66,0,-66
7357,1,1,734,1622,888
7358,1,0,102,0,-102
7359,1,1,1017,3055,2038
7360,0,0,10,0,-10
7361,0,0,108,0,-108
7362,1,1,738,1483,745
7363,1,1,427,1435,1008
7364,1,1,255,1229,974
7365,1,0,13,0,-13
7366,0,0,240,0,-240
7367,1,0,4,0,-4
7368,0,0,0,0,0
7369,1,1,327,1565,1238
7370,1,0,150,0,-150
7371,1,1,201,1306,1105
7372,0,0,6,0,-6
7373,0,0,34,0,-34
7374,1,1,2517,1508,-1009
7375,0,0,16,0,-16
7376,0,0,78,0,-78
7377,0,0,64,0,-64
7378,0,0,19,0,-19
7379,1,1,115,1763,1648
7380,1,1,298,1460,1162
7381,0,0,1,0,-1
7382,1,0,56,0,-56
7383,0,0,6,0,-6
7384,1,1,148,1206,1058
7385,0,0,128,0,-128
7386,1,1,271,1492,1221
7387,0,0,60,0,-60
7388,1,1,96,1699,1603
7389,0,0,26,0,-26
7390,1,1,489,2045,1556
7391,1,1,304,1418,1114
7392,1,1,248,1595,1347
7393,1,0,67,0,-67
7394,0,0,119,0,-119
7395,0,0,23,0,-23
7396,0,0,15,0,-15
7397,0,0,7,0,-7
7398,1,1,225,1295,1070
7399,1,0,28,0,-28
7400,0,0,46,0,-46
7401,0,0,2,0,-2
7402,1,1,189,1224,1035
7403,1,0,256,0,-256
7404,0,0,65,0,-65
7405,1,1,303,1575,1272
7406,1,1,1366,1290,-76
7407,1,1,166,3035,2869
7408,1,0,100,0,-100
7409,1,1,214,1618,1404
7410,0,0,89,0,-89
7411,1,1,202,1446,1244
7412,1,1,1435,1225,-210
7413,0,0,7,0,-7
7414,0,0,125,0,-125
7415,0,0,1,0,-1
7416,1,0,5,0,-5
7417,1,0,194,0,-194
7418,1,0,80,0,-80
7419,1,0,3,0,-3
7420,0,0,33,0,-33
7421,0,0,35,0,-35
7422,1,1,847,1350,503
7423,0,0,1,0,-1
7424,0,0,29,0,-29
7425,0,0,13,0,-13
7426,1,0,8,0,-8
7427,1,0,29,0,-29
7428,0,0,31,0,-31
7429,1,1,357,1354,997
7430,0,0,48,0,-48
7431,1,0,74,0,-74
7432,1,0,33,0,-33
7433,0,0,5,0,-5
7434,1,1,876,1740,864
7435,0,0,16,0,-16
7436,1,1,259,1445,1186
7437,1,1,927,1543,616
7438,1,0,58,0,-58
7439,1,0,120,0,-120
7440,0,0,105,0,-105
7441,0,0,5,0,-5
7442,1,0,29,0,-29
7443,0,0,26,0,-26
7444,1,1,418,1655,1237
7445,0,0,23,0,-23
7446,1,0,18,0,-18
7447,1,1,24,1557,1533
7448,0,0,88,0,-88
7449,1,0,146,0,-146
7450,1,1,1066,1315,249
7451,0,0,6,0,-6
7452,1,1,652,2271,1619
7453,0,0,14,0,-14
7454,1,1,446,2138,1692
7455,1,1,982,1516,534
7456,1,0,1,0,-1
7457,1,0,22,0,-22
7458,0,0,10,0,-10
7459,1,1,192,1615,1423
7460,1,1,124,1970,1846
7461,1,0,7,0,-7
7462,1,1,175,1570,1395
7463,1,0,37,0,-37
7464,1,1,1697,1926,229
7465,1,0,3,0,-3
7466,0,0,54,0,-54
7467,1,0,39,0,-39
7468,1,1,57,1751,1694
7469,1,0,76,0,-76
7470,0,0,252,0,-252
7471,1,1,144,1202,1058
7472,1,0,1,0,-1
7473,1,1,894,1230,336
7474,1,1,338,1212,874
7475,0,0,228,0,-228
7476,1,0,121,0,-121
7477,1,0,82,0,-82
7478,1,0,93,0,-93
7479,1,0,97,0,-97
7480,1,0,35,0,-35
7481,0,0,38,0,-38
7482,0,0,46,0,-46
7483,0,0,11,0,-11
7484,0,0,19,0,-19
7485,0,0,69,0,-69
7486,1,1,744,1252,508
7487,0,0,144,0,-144
7488,0,0,33,0,-33
7489,1,1,1084,1292,208
7490,0,0,19,0,-19
7491,0,0,50,0,-50
7492,0,0,32,0,-32
7493,1,1,555,1645,1090
7494,1,1,1585,1221,-364
7495,0,0,32,0,-32
7496,1,1,769,1273,504
7497,0,0,15,0,-15
7498,0,0,29,0,-29
7499,0,0,0,0,0
7500,1,0,32,0,-32
7501,1,1,37,2597,2560
7502,0,0,5,0,-5
7503,1,0,8,0,-8
7504,0,0,21,0,-21
7505,0,0,49,0,-49
7506,1,1,1346,1264,-82
7507,0,0,63,0,-63
7508,1,0,51,0,-51
7509,1,1,213,1428,1215
7510,0,0,71,0,-71
7511,1,1,143,1282,1139
7512,1,0,70,0,-70
7513,1,1,2379,1200,-1179
7514,1,1,535,1367,832
7515,1,1,271,1248,977
7516,1,1,322,1231,909
7517,0,0,6,0,-6
7518,1,1,169,1449,1280
7519,1,0,2,0,-2
7520,1,1,887,1273,386
7521,0,0,68,0,-68
7522,1,0,75,0,-75
7523,0,0,7,0,-7
7524,1,0,59,0,-59
7525,0,0,21,0,-21
7526,1,1,428,3277,2849
7527,1,1,171,1276,1105
7528,0,0,44,0,-44
7529,1,1,1020,1455,435
7530,0,0,16,0,-16
7531,1,0,0,0,0
7532,0,0,128,0,-128
7533,1,0,0,0,0
7534,0,0,64,0,-64
7535,0,0,22,0,-22
7536,1,0,59,0,-59
7537,1,1,902,1461,559
7538,1,1,120,1514,1394
7539,0,0,41,0,-41
7540,0,0,131,0,-131
7541,1,1,198,1233,1035
7542,1,0,23,0,-23
7543,0,0,33,0,-33
7544,1,1,676,1280,604
7545,1,1,803,1318,515
7546,1,0,74,0,-74
7547,1,1,199,1750,1551
7548,0,0,110,0,-110
7549,1,1,152,1880,1728
7550,1,1,130,1272,1142
7551,1,1,191,2699,2508
7552,0,0,90,0,-90
7553,1,0,28,0,-28
7554,0,0,54,0,-54
7555,0,0,163,0,-163
7556,0,0,131,0,-131
7557,1,1,977,1301,324
7558,0,0,18,0,-18
7559,0,0,53,0,-53
7560,1,1,149,1267,1118
7561,1,0,5,0,-5
7562,0,0,1,0,-1
7563,0,0,13,0,-13
7564,1,1,672,1265,593
7565,0,0,2,0,-2
7566,1,0,95,0,-95
7567,1,0,5,0,-5
7568,1,1,435,1282,847
7569,0,0,32,0,-32
7570,0,0,12,0,-12
7571,0,0,119,0,-119
7572,0,0,11,0,-11
7573,0,0,35,0,-35
7574,0,0,21,0,-21
7575,1,1,284,3211,2927
7576,0,0,32,0,-32
7577,0,0,27,0,-27
7578,0,0,63,0,-63
7579,1,1,133,1562,1429
7580,1,1,153,1256,1103
7581,1,1,679,1452,773
7582,1,1,95,1649,1554
7583,1,1,337,1450,1113
7584,1,1,181,1306,1125
7585,0,0,97,0,-97
7586,0,0,45,0,-45
7587,1,0,2,0,-2
7588,1,0,43,0,-43
7589,0,0,59,0,-59
7590,0,0,19,0,-19
7591,1,0,19,0,-19
7592,1,0,103,0,-103
7593,1,0,34,0,-34
7594,1,1,572,2124,1552
7595,1,0,68,0,-68
7596,0,0,22,0,-22
7597,0,0,60,0,-60
7598,0,0,62,0,-62
7599,1,1,116,1275,1159
7600,0,0,2,0,-2
7601,1,0,27,0,-27
7602,0,0,12,0,-12
7603,0,0,62,0,-62
7604,1,0,24,0,-24
7605,0,0,56,0,-56
7606,0,0,91,0,-91
7607,0,0,4,0,-4
7608,0,0,199,0,-199
7609,1,0,24,0,-24
7610,1,1,1190,1752,562
7611,1,1,1436,1200,-236
7612,1,0,34,0,-34
7613,0,0,103,0,-103
7614,0,0,73,0,-73
7615,0,0,29,0,-29
7616,0,0,27,0,-27
7617,0,0,5,0,-5
7618,1,0,202,0,-202
7619,1,0,26,0,-26
7620,1,0,5,0,-5
7621,0,0,49,0,-49
7622,0,0,139,0,-139
7623,0,0,97,0,-97
7624,1,1,144,1260,1116
7625,1,1,148,1419,1271
7626,1,0,12,0,-12
7627,1,1,519,1562,1043
7628,0,0,85,0,-85
7629,0,0,1,0,-1
7630,1,1,230,2169,1939
7631,1,1,788,1800,1012
7632,1,0,23,0,-23
7633,1,0,21,0,-21
7634,0,0,124,0,-124
7635,1,0,60,0,-60
7636,0,0,26,0,-26
7637,1,0,12,0,-12
7638,0,0,55,0,-55
7639,1,1,82,2275,2193
7640,0,0,83,0,-83
7641,1,1,303,1366,1063
7642,1,1,2277,1254,-1023
7643,0,0,14,0,-14
7644,1,0,23,0,-23
7645,1,0,72,0,-72
7646,1,1,290,1218,928
7647,1,0,90,0,-90
7648,1,1,127,4445,4318
7649,1,0,164,0,-164
7650,0,0,51,0,-51
7651,1,0,22,0,-22
7652,0,0,51,0,-51
7653,1,0,77,0,-77
7654,1,1,176,1490,1314
7655,1,1,156,1468,1312
7656,1,0,54,0,-54
7657,0,0,42,0,-42
7658,1,0,18,0,-18
7659,1,1,820,1544,724
7660,1,0,12,0,-12
7661,1,1,1834,1207,-627
7662,1,0,11,0,-11
7663,0,0,0,0,0
7664,1,1,1167,2229,1062
7665,1,1,1869,1273,-596
7666,1,0,207,0,-207
7667,1,0,10,0,-10
7668,0,0,44,0,-44
7669,0,0,242,0,-242
7670,1,0,35,0,-35
7671,1,0,59,0,-59
7672,1,0,72,0,-72
7673,0,0,82,0,-82
7674,1,0,181,0,-181
7675,0,0,15,0,-15
7676,0,0,57,0,-57
7677,1,0,46,0,-46
7678,1,1,372,1508,1136
7679,1,0,129,0,-129
7680,1,0,78,0,-78
7681,0,0,9,0,-9
7682,0,0,5,0,-5
7683,0,0,58,0,-58
7684,1,0,54,0,-54
7685,1,0,89,0,-89
7686,1,1,264,1395,1131
7687,1,1,1185,1359,174
7688,1,0,156,0,-156
7689,0,0,53,0,-53
7690,1,1,2106,2257,151
7691,0,0,55,0,-55
7692,0,0,26,0,-26
7693,1,1,335,1259,924
7694,0,0,60,0,-60
7695,1,0,77,0,-77
7696,1,1,579,2251,1672
7697,1,1,361,1374,1013
7698,1,0,117,0,-117
7699,1,0,40,0,-40
7700,1,0,145,0,-145
7701,1,1,74,3132,3058
7702,1,0,24,0,-24
7703,0,0,77,0,-77
7704,0,0,8,0,-8
7705,1,1,288,1713,1425
7706,1,0,29,0,-29
7707,0,0,35,0,-35
7708,0,0,3,0,-3
7709,0,0,42,0,-42
7710,0,0,124,0,-124
7711,1,0,13,0,-13
7712,0,0,86,0,-86
7713,1,0,14,0,-14
7714,1,0,50,0,-50
7715,0,0,46,0,-46
7716,1,1,1792,1248,-544
7717,0,0,4,0,-4
7718,1,0,18,0,-18
7719,1,1,96,1340,1244
7720,1,0,0,0,0
7721,0,0,22,0,-22
7722,1,1,211,1333,1122
7723,0,0,61,0,-61
7724,1,1,651,1365,714
7725,1,1,46,1540,1494
7726,1,1,1199,1592,393
7727,1,1,178,1810,1632
7728,1,1,409,1329,920
7729,1,0,67,0,-67
7730,1,1,266,1375,1109
7731,0,0,32,0,-32
7732,1,0,73,0,-73
7733,0,0,70,0,-70
7734,0,0,6,0,-6
7735,1,0,64,0,-64
7736,1,1,352,1528,1176
7737,1,1,198,1630,1432
7738,1,1,427,1294,867
7739,1,1,249,2086,1837
7740,1,1,168,1227,1059
7741,0,0,21,0,-21
7742,1,0,49,0,-49
7743,0,0,35,0,-35
7744,1,0,49,0,-49
7745,1,0,2,0,-2
7746,1,0,79,0,-79
7747,0,0,89,0,-89
7748,0,0,177,0,-177
7749,1,1,138,1968,1830
7750,1,1,2307,1530,-777
7751,0,0,65,0,-65
7752,0,0,116,0,-116
7753,1,1,175,1651,1476
7754,0,0,39,0,-39
7755,0,0,2,0,-2
7756,1,1,368,1879,1511
7757,1,1,1490,1489,-1
7758,0,0,15,0,-15
7759,0,0,10,0,-10
7760,1,0,0,0,0
7761,0,0,87,0,-87
7762,1,1,47,1591,1544
7763,0,0,26,0,-26
7764,0,0,41,0,-41
7765,0,0,24,0,-24
7766,0,0,149,0,-149
7767,1,0,93,0,-93
7768,1,1,669,1626,957
7769,0,0,5,0,-5
7770,1,1,282,1226,944
7771,1,0,3,0,-3
7772,0,0,11,0,-11
7773,1,1,434,1287,853
7774,0,0,0,0,0
7775,1,1,365,1602,1237
7776,0,0,17,0,-17
7777,1,0,70,0,-70
7778,1,1,539,1864,1325
7779,1,0,96,0,-96
7780,0,0,43,0,-43
7781,1,1,1027,1230,203
7782,1,0,2,0,-2
7783,1,0,104,0,-104
7784,0,0,56,0,-56
7785,1,1,474,1470,996
7786,1,1,144,5184,5040
7787,1,0,135,0,-135
7788,1,0,74,0,-74
7789,1,1,387,2706,2319
7790,1,1,273,1893,1620
7791,0,0,122,0,-122
7792,1,0,52,0,-52
7793,0,0,92,0,-92
7794,1,1,446,1218,772
7795,0,0,36,0,-36
7796,0,0,217,0,-217
7797,1,1,439,1490,1051
7798,1,1,2664,2986,322
7799,1,1,240,1437,1197
7800,1,0,8,0,-8
7801,1,0,8,0,-8
7802,0,0,1,0,-1
7803,0,0,70,0,-70
7804,0,0,50,0,-50
7805,1,0,10,0,-10
7806,0,0,59,0,-59
7807,0,0,104,0,-104
7808,1,1,717,2496,1779
7809,0,0,2,0,-2
7810,0,0,43,0,-43
7811,0,0,66,0,-66
7812,0,0,10,0,-10
7813,1,0,16,0,-16
7814,1,1,509,2251,1742
7815,0,0,32,0,-32
7816,0,0,15,0,-15
7817,1,1,483,1226,743
7818,0,0,25,0,-25
7819,1,0,109,0,-109
7820,1,0,7,0,-7
7821,1,0,11,0,-11
7822,1,1,184,1220,1036
7823,1,0,144,0,-144
7824,1,0,28,0,-28
7825,1,0,7,0,-7
7826,0,0,46,0,-46
7827,0,0,20,0,-20
7828,0,0,145,0,-145
7829,1,0,33,0,-33
7830,1,0,60,0,-60
7831,0,0,124,0,-124
7832,0,0,32,0,-32
7833,1,1,722,1264,542
7834,1,0,44,0,-44
7835,1,0,86,0,-86
7836,1,0,63,0,-63
7837,1,0,170,0,-170
7838,0,0,86,0,-86
7839,1,0,73,0,-73
7840,0,0,22,0,-22
7841,1,1,221,1600,1379
7842,1,0,18,0,-18
7843,0,0,46,0,-46
7844,1,1,1021,1219,198
7845,1,0,34,0,-34
7846,0,0,92,0,-92
7847,0,0,25,0,-25
7848,1,0,69,0,-69
7849,0,0,12,0,-12
7850,1,1,1279,1294,15
7851,1,1,176,1360,1184
7852,1,1,1097,1224,127
7853,0,0,47,0,-47
7854,1,0,17,0,-17
7855,1,0,127,0,-127
7856,1,1,330,1257,927
7857,0,0,61,0,-61
7858,0,0,0,0,0
7859,0,0,4,0,-4
7860,0,0,57,0,-57
7861,1,1,420,1203,783
7862,0,0,182,0,-182
7863,1,0,43,0,-43
7864,0,0,28,0,-28
7865,0,0,20,0,-20
7866,1,0,15,0,-15
7867,1,0,31,0,-31
7868,1,1,133,1319,1186
7869,1,1,164,2529,2365
7870,1,0,115,0,-115
7871,1,0,19,0,-19
7872,0,0,70,0,-70
7873,1,0,11,0,-11
7874,0,0,2,0,-2
7875,1,0,2,0,-2
7876,0,0,63,0,-63
7877,0,0,191,0,-191
7878,1,1,1018,1567,549
7879,0,0,55,0,-55
7880,0,0,9,0,-9
7881,1,1,372,1543,1171
7882,1,0,71,0,-71
7883,1,0,39,0,-39
7884,0,0,18,0,-18
7885,0,0,46,0,-46
7886,1,1,803,1205,402
7887,0,0,21,0,-21
7888,0,0,19,0,-19
7889,1,0,66,0,-66
7890,0,0,40,0,-40
7891,1,1,1011,2769,1758
7892,1,0,127,0,-127
7893,1,0,12,0,-12
7894,1,1,274,1336,1062
7895,1,0,81,0,-81
7896,1,1,263,1615,1352
7897,1,1,208,2096,1888
7898,0,0,62,0,-62
7899,1,0,1,0,-1
7900,1,0,3,0,-3
7901,0,0,35,0,-35
7902,0,0,82,0,-82
7903,0,0,22,0,-22
7904,0,0,15,0,-15
7905,0,0,28,0,-28
7906,0,0,7,0,-7
7907,0,0,93,0,-93
7908,0,0,97,0,-97
7909,1,1,140,1409,1269
7910,1,0,29,0,-29
7911,1,1,94,1296,1202
7912,0,0,48,0,-48
7913,1,0,0,0,0
7914,1,0,279,0,-279
7915,0,0,129,0,-129
7916,0,0,52,0,-52
7917,1,1,507,1215,708
7918,1,0,99,0,-99
7919,1,0,8,0,-8
7920,0,0,27,0,-27
7921,0,0,29,0,-29
7922,0,0,51,0,-51
7923,0,0,1,0,-1
7924,0,0,67,0,-67
7925,1,1,63,1219,1156
7926,1,1,608,2097,1489
7927,1,1,237,1706,1469
7928,0,0,12,0,-12
7929,1,1,203,1322,1119
7930,0,0,4,0,-4
7931,1,0,52,0,-52
7932,0,0,84,0,-84
7933,0,0,215,0,-215
7934,0,0,13,0,-13
7935,1,1,275,2516,2241
7936,1,1,353,1652,1299
7937,1,0,31,0,-31
7938,1,1,106,1537,1431
7939,1,0,24,0,-24
7940,0,0,19,0,-19
7941,1,1,706,1325,619
7942,0,0,21,0,-21
7943,1,1,527,2119,1592
7944,1,0,1,0,-1
7945,1,1,1479,1212,-267
7946,0,0,117,0,-117
7947,1,1,313,1612,1299
7948,1,1,672,2377,1705
7949,1,1,245,1371,1126
7950,0,0,26,0,-26
7951,0,0,11,0,-11
7952,1,0,91,0,-91
7953,0,0,193,0,-193
7954,0,0,51,0,-51
7955,1,0,27,0,-27
7956,1,1,523,1457,934
7957,1,0,35,0,-35
7958,0,0,90,0,-90
7959,1,1,962,1319,357
7960,1,1,305,1397,1092
7961,0,0,58,0,-58
7962,1,0,17,0,-17
7963,0,0,147,0,-147
7964,1,0,14,0,-14
7965,1,0,40,0,-40
7966,1,0,10,0,-10
7967,0,0,57,0,-57
7968,1,0,36,0,-36
7969,1,1,551,1222,671
7970,1,1,655,1308,653
7971,0,0,25,0,-25
7972,1,0,3,0,-3
7973,0,0,9,0,-9
7974,0,0,15,0,-15
7975,1,1,128,1394,1266
7976,1,1,558,1527,969
7977,0,0,14,0,-14
7978,1,0,85,0,-85
7979,1,0,12,0,-12
7980,0,0,0,0,0
7981,0,0,6,0,-6
7982,1,0,1,0,-1
7983,0,0,43,0,-43
7984,1,1,210,1237,1027
7985,0,0,84,0,-84
7986,1,0,63,0,-63
7987,0,0,53,0,-53
7988,1,0,76,0,-76
7989,0,0,9,0,-9
7990,0,0,6,0,-6
7991,0,0,98,0,-98
7992,0,0,28,0,-28
7993,1,1,980,1347,367
7994,1,1,1363,1371,8
7995,0,0,65,0,-65
7996,1,0,0,0,0
7997,1,1,335,1559,1224
7998,0,0,93,0,-93
7999,0,0,48,0,-48
8000,0,0,43,0,-43
8001,1,0,22,0,-22
8002,1,0,19,0,-19
8003,0,0,54,0,-54
8004,0,0,14,0,-14
8005,1,0,47,0,-47
8006,1,1,59,1324,1265
8007,0,0,89,0,-89
8008,1,1,131,1799,1668
8009,1,0,11,0,-11
8010,1,0,34,0,-34
8011,1,0,64,0,-64
8012,1,1,1257,1669,412
8013,1,0,79,0,-79
8014,0,0,7,0,-7
8015,0,0,39,0,-39
8016,1,1,167,1238,1071
8017,1,1,984,1376,392
8018,0,0,251,0,-251
8019,0,0,43,0,-43
8020,1,1,156,1647,1491
8021,1,0,20,0,-20
8022,1,0,3,0,-3
8023,0,0,143,0,-143
8024,1,1,378,1532,1154
8025,1,0,37,0,-37
8026,0,0,4,0,-4
8027,1,1,504,1714,1210
8028,1,0,15,0,-15
8029,0,0,3,0,-3
8030,0,0,61,0,-61
8031,0,0,47,0,-47
8032,1,0,38,0,-38
8033,0,0,0,0,0
8034,1,0,10,0,-10
8035,0,0,64,0,-64
8036,1,1,1128,1531,403
8037,1,1,1123,1395,272
8038,1,0,20,0,-20
8039,1,0,3,0,-3
8040,1,1,61,1494,1433
8041,1,0,54,0,-54
8042,0,0,23,0,-23
8043,1,0,16,0,-16
8044,0,0,126,0,-126
8045,1,0,11,0,-11
8046,0,0,86,0,-86
8047,1,0,88,0,-88
8048,0,0,76,0,-76
8049,0,0,276,0,-276
8050,1,0,48,0,-48
8051,1,0,12,0,-12
8052,1,0,20,0,-20
8053,1,0,23,0,-23
8054,0,0,44,0,-44
8055,1,1,327,1256,929
8056,1,1,585,2214,1629
8057,0,0,22,0,-22
8058,1,1,322,1216,894
8059,0,0,22,0,-22
8060,0,0,0,0,0
8061,0,0,8,0,-8
8062,0,0,18,0,-18
8063,1,1,158,1317,1159
8064,1,1,1786,1456,-330
8065,1,1,1073,1248,175
8066,1,0,1,0,-1
8067,0,0,13,0,-13
8068,0,0,135,0,-135
8069,1,0,134,0,-134
8070,1,1,163,2124,1961
8071,1,0,79,0,-79
8072,0,0,1,0,-1
8073,0,0,8,0,-8
8074,1,0,2,0,-2
8075,1,0,115,0,-115
8076,1,0,28,0,-28
8077,0,0,90,0,-90
8078,1,1,766,1314,548
8079,0,0,27,0,-27
8080,0,0,20,0,-20
8081,1,1,283,1277,994
8082,0,0,44,0,-44
8083,1,0,18,0,-18
8084,1,1,218,1455,1237
8085,1,0,14,0,-14
8086,1,1,189,1294,1105
8087,0,0,21,0,-21
8088,1,0,31,0,-31
8089,1,1,941,1363,422
8090,1,0,16,0,-16
8091,0,0,24,0,-24
8092,1,0,32,0,-32
8093,1,1,161,1339,1178
8094,1,0,34,0,-34
8095,1,0,11,0,-11
8096,1,0,11,0,-11
8097,0,0,35,0,-35
8098,1,1,302,1424,1122
8099,1,0,5,0,-5
8100,1,1,463,1287,824
8101,1,0,45,0,-45
8102,0,0,17,0,-17
8103,1,0,33,0,-33
8104,1,0,1,0,-1
8105,0,0,7,0,-7
8106,0,0,14,0,-14
8107,0,0,72,0,-72
8108,0,0,56,0,-56
8109,1,0,169,0,-169
8110,1,0,96,0,-96
8111,1,1,1082,1648,566
8112,1,1,87,1583,1496
8113,0,0,19,0,-19
8114,1,1,1650,1306,-344
8115,1,1,41,1447,1406
8116,1,1,624,1200,576
8117,0,0,1,0,-1
8118,0,0,184,0,-184
8119,1,0,30,0,-30
8120,1,0,12,0,-12
8121,0,0,58,0,-58
8122,1,1,313,1670,1357
8123,0,0,35,0,-35
8124,0,0,17,0,-17
8125,1,1,451,1351,900
8126,0,0,218,0,-218
8127,0,0,0,0,0
8128,1,1,673,1331,658
8129,1,1,158,1255,1097
8130,1,0,53,0,-53
8131,1,1,778,1281,503
8132,1,1,902,1651,749
8133,1,1,1241,1262,21
8134,0,0,36,0,-36
8135,1,1,214,1230,1016
8136,0,0,10,0,-10
8137,1,0,6,0,-6
8138,1,0,30,0,-30
8139,1,0,12,0,-12
8140,1,1,458,2018,1560
8141,1,1,606,1665,1059
8142,1,0,139,0,-139
8143,1,1,81,2102,2021
8144,1,1,719,1242,523
8145,1,1,296,1319,1023
8146,0,0,64,0,-64
8147,0,0,63,0,-63
8148,0,0,77,0,-77
8149,0,0,32,0,-32
8150,0,0,52,0,-52
8151,1,0,83,0,-83
8152,1,1,411,1353,942
8153,0,0,20,0,-20
8154,1,0,71,0,-71
8155,1,1,677,1261,584
8156,1,0,37,0,-37
8157,1,0,120,0,-120
8158,1,1,786,1284,498
8159,1,0,8,0,-8
8160,1,0,58,0,-58
8161,1,0,109,0,-109
8162,1,0,31,0,-31
8163,0,0,83,0,-83
8164,0,0,14,0,-14
8165,0,0,12,0,-12
8166,0,0,10,0,-10
8167,1,1,68,1237,1169
8168,1,0,100,0,-100
8169,1,0,10,0,-10
8170,0,0,0,0,0
8171,1,0,6,0,-6
8172,0,0,16,0,-16
8173,0,0,40,0,-40
8174,1,0,21,0,-21
8175,0,0,83,0,-83
8176,1,0,18,0,-18
8177,1,0,50,0,-50
8178,0,0,26,0,-26
8179,0,0,9,0,-9
8180,0,0,20,0,-20
8181,1,0,19,0,-19
8182,1,1,375,1470,1095
8183,1,1,711,1412,701
8184,1,1,1537,1289,-248
8185,1,0,42,0,-42
8186,1,1,127,2126,1999
8187,1,1,548,1989,1441
8188,1,1,504,1716,1212
8189,0,0,14,0,-14
8190,1,0,1,0,-1
8191,0,0,32,0,-32
8192,0,0,46,0,-46
8193,0,0,7,0,-7
8194,1,0,34,0,-34
8195,0,0,3,0,-3
8196,1,1,837,1956,1119
8197,0,0,1,0,-1
8198,1,1,899,1209,310
8199,1,0,25,0,-25
8200,1,0,160,0,-160
8201,1,1,375,1244,869
8202,1,1,121,1670,1549
8203,1,1,143,1571,1428
8204,0,0,40,0,-40
8205,0,0,16,0,-16
8206,0,0,22,0,-22
8207,1,0,70,0,-70
8208,1,0,0,0,0
8209,0,0,13,0,-13
8210,1,0,29,0,-29
8211,0,0,34,0,-34
8212,1,1,1415,1602,187
8213,0,0,41,0,-41
8214,1,0,37,0,-37
8215,0,0,11,0,-11
8216,1,1,226,1211,985
8217,0,0,141,0,-141
8218,0,0,95,0,-95
8219,1,0,38,0,-38
8220,1,0,54,0,-54
8221,0,0,8,0,-8
8222,1,1,419,1565,1146
8223,1,1,101,1228,1127
8224,0,0,88,0,-88
8225,1,0,7,0,-7
8226,1,0,26,0,-26
8227,0,0,187,0,-187
8228,1,1,259,1681,1422
8229,1,0,5,0,-5
8230,1,1,215,1649,1434
8231,0,0,37,0,-37
8232,0,0,94,0,-94
8233,1,0,13,0,-13
8234,1,1,575,1307,732
8235,0,0,86,0,-86
8236,1,0,28,0,-28
8237,1,1,169,1929,1760
8238,1,0,15,0,-15
8239,0,0,65,0,-65
8240,0,0,250,0,-250
8241,0,0,69,0,-69
8242,1,0,47,0,-47
8243,1,1,688,1473,785
8244,1,1,782,1218,436
8245,1,0,140,0,-140
8246,1,0,27,0,-27
8247,0,0,45,0,-45
8248,1,1,627,1308,681
8249,1,1,783,1290,507
8250,1,0,3,0,-3
8251,1,0,65,0,-65
8252,0,0,54,0,-54
8253,0,0,38,0,-38
8254,1,0,27,0,-27
8255,1,0,33,0,-33
8256,1,0,129,0,-129
8257,0,0,27,0,-27
8258,1,1,390,1584,1194
8259,1,1,350,1318,968
8260,1,0,48,0,-48
8261,1,0,15,0,-15
8262,0,0,136,0,-136
8263,0,0,10,0,-10
8264,0,0,1,0,-1
8265,0,0,94,0,-94
8266,0,0,51,0,-51
8267,0,0,14,0,-14
8268,1,1,145,1322,1177
8269,0,0,47,0,-47
8270,0,0,13,0,-13
8271,1,0,40,0,-40
8272,1,1,859,1473,614
8273,1,0,55,0,-55
8274,0,0,9,0,-9
8275,1,0,1,0,-1
8276,1,1,290,1255,965
8277,1,1,540,1241,701
8278,1,1,1047,1626,579
8279,1,1,201,1613,1412
8280,1,0,5,0,-5
8281,0,0,34,0,-34
8282,0,0,50,0,-50
8283,1,1,107,1923,1816
8284,1,0,98,0,-98
8285,1,0,13,0,-13
8286,1,1,800,1242,442
8287,0,0,15,0,-15
8288,1,0,30,0,-30
8289,1,0,0,0,0
8290,1,1,311,1206,895
8291,0,0,171,0,-171
8292,1,0,39,0,-39
8293,0,0,50,0,-50
8294,1,1,754,1228,474
8295,1,0,28,0,-28
8296,1,1,2202,1295,-907
8297,0,0,11,0,-11
8298,1,0,0,0,0
8299,1,0,26,0,-26
8300,1,1,1930,1268,-662
8301,1,0,39,0,-39
8302,0,0,65,0,-65
8303,0,0,40,0,-40
8304,1,0,64,0,-64
8305,1,0,11,0,-11
8306,1,1,262,1882,1620
8307,0,0,7,0,-7
8308,1,0,26,0,-26
8309,0,0,37,0,-37
8310,1,0,131,0,-131
8311,0,0,8,0,-8
8312,0,0,45,0,-45
8313,1,0,40,0,-40
8314,0,0,26,0,-26
8315,1,1,267,1248,981
8316,1,0,9,0,-9
8317,1,1,328,1202,874
8318,1,0,24,0,-24
8319,0,0,186,0,-186
8320,1,1,950,1212,262
8321,1,1,449,1369,920
8322,0,0,77,0,-77
8323,0,0,91,0,-91
8324,1,1,110,1422,1312
8325,0,0,152,0,-152
8326,0,0,22,0,-22
8327,0,0,37,0,-37
8328,0,0,47,0,-47
8329,0,0,90,0,-90
8330,1,0,2,0,-2
8331,0,0,3,0,-3
8332,1,0,18,0,-18
8333,1,0,27,0,-27
8334,1,1,29,1398,1369
8335,1,1,662,1662,1000
8336,1,1,1057,3092,2035
8337,1,0,38,0,-38
8338,1,0,26,0,-26
8339,1,0,0,0,0
8340,1,1,1468,1615,147
8341,1,0,37,0,-37
8342,1,1,207,1442,1235
8343,0,0,78,0,-78
8344,0,0,254,0,-254
8345,1,0,13,0,-13
8346,1,1,268,1518,1250
8347,0,0,43,0,-43
8348,0,0,4,0,-4
8349,1,0,52,0,-52
8350,0,0,56,0,-56
8351,1,0,198,0,-198
8352,0,0,0,0,0
8353,0,0,9,0,-9
8354,0,0,69,0,-69
8355,0,0,12,0,-12
8356,0,0,24,0,-24
8357,1,1,388,1786,1398
8358,1,0,39,0,-39
8359,1,1,408,2357,1949
8360,1,1,987,1917,930
8361,1,0,128,0,-128
8362,0,0,7,0,-7
8363,1,0,20,0,-20
8364,1,1,297,1327,1030
8365,1,0,15,0,-15
8366,1,0,13,0,-13
8367,0,0,13,0,-13
8368,0,0,11,0,-11
8369,0,0,58,0,-58
8370,1,0,1,0,-1
8371,1,1,1055,1251,196
8372,1,1,712,1444,732
8373,0,0,69,0,-69
8374,0,0,129,0,-129
8375,0,0,7,0,-7
8376,1,1,874,1370,496
8377,0,0,56,0,-56
8378,1,1,622,1846,1224
8379,1,0,78,0,-78
8380,1,1,178,1347,1169
8381,0,0,20,0,-20
8382,1,0,173,0,-173
8383,1,0,0,0,0
8384,0,0,24,0,-24
8385,1,1,1108,1610,502
8386,1,0,111,0,-111
8387,0,0,47,0,-47
8388,1,1,207,1235,1028
8389,0,0,105,0,-105
8390,1,0,135,0,-135
8391,1,0,38,0,-38
8392,1,1,1270,3101,1831
8393,1,0,26,0,-26
8394,1,0,324,0,-324
8395,1,0,165,0,-165
8396,1,1,528,2112,1584
8397,1,0,63,0,-63
8398,1,0,1,0,-1
8399,1,0,109,0,-109
8400,1,1,1760,1443,-317
8401,0,0,2,0,-2
8402,1,1,319,1226,907
8403,0,0,76,0,-76
8404,1,1,2051,1440,-611
8405,1,1,745,1515,770
8406,1,1,172,1284,1112
8407,0,0,138,0,-138
8408,0,0,0,0,0
8409,0,0,11,0,-11
8410,1,0,0,0,0
8411,0,0,10,0,-10
8412,1,0,40,0,-40
8413,1,1,2201,1904,-297
8414,1,1,266,1201,935
8415,1,1,327,2527,2200
8416,1,1,281,1355,1074
8417,1,1,601,1565,964
8418,1,1,262,1337,1075
8419,0,0,29,0,-29
8420,1,0,8,0,-8
8421,0,0,42,0,-42
8422,1,1,83,1548,1465
8423,0,0,23,0,-23
8424,1,1,52,1583,1531
8425,0,0,6,0,-6
8426,0,0,63,0,-63
8427,1,1,156,1922,1766
8428,0,0,44,0,-44
8429,1,1,2548,2017,-531
8430,0,0,22,0,-22
8431,0,0,60,0,-60
8432,1,1,351,1515,1164
8433,1,0,6,0,-6
8434,1,1,240,1912,1672
8435,1,0,72,0,-72
8436,1,0,21,0,-21
8437,0,0,25,0,-25
8438,1,1,536,1213,677
8439,0,0,14,0,-14
8440,0,0,80,0,-80
8441,0,0,42,0,-42
8442,0,0,19,0,-19
8443,1,1,48,1731,1683
8444,1,1,258,1385,1127
8445,0,0,1,0,-1
8446,0,0,70,0,-70
8447,0,0,99,0,-99
8448,1,1,207,1379,1172
8449,0,0,45,0,-45
8450,1,1,155,1304,1149
8451,1,1,1214,1322,108
8452,1,1,988,1827,839
8453,1,0,44,0,-44
8454,0,0,64,0,-64
8455,0,0,47,0,-47
8456,1,0,65,0,-65
8457,1,0,112,0,-112
8458,1,1,572,1289,717
8459,0,0,47,0,-47
8460,1,0,37,0,-37
8461,1,0,25,0,-25
8462,0,0,100,0,-100
8463,0,0,12,0,-12
8464,1,0,125,0,-125
8465,1,0,19,0,-19
8466,0,0,21,0,-21
8467,1,1,871,1536,665
8468,0,0,21,0,-21
8469,0,0,109,0,-109
8470,0,0,10,0,-10
8471,0,0,12,0,-12
8472,1,0,205,0,-205
8473,1,1,265,1521,1256
8474,1,1,433,1649,1216
8475,0,0,37,0,-37
8476,1,1,692,1255,563
8477,0,0,33,0,-33
8478,0,0,2,0,-2
8479,0,0,106,0,-106
8480,1,1,2072,1347,-725
8481,0,0,41,0,-41
8482,1,0,2,0,-2
8483,0,0,23,0,-23
8484,0,0,21,0,-21
8485,0,0,172,0,-172
8486,1,1,971,1900,929
8487,0,0,4,0,-4
8488,0,0,45,0,-45
8489,1,1,207,1237,1030
8490,1,1,1000,1209,209
8491,1,0,69,0,-69
8492,1,1,186,1743,1557
8493,1,1,56,1431,1375
8494,0,0,50,0,-50
8495,0,0,20,0,-20
8496,1,1,422,1415,993
8497,1,0,90,0,-90
8498,1,0,7,0,-7
8499,1,0,35,0,-35
8500,0,0,22,0,-22
8501,1,1,2166,1472,-694
8502,0,0,46,0,-46
8503,1,0,6,0,-6
8504,1,0,33,0,-33
8505,1,1,193,1411,1218
8506,1,0,28,0,-28
8507,1,1,483,1541,1058
8508,1,1,1929,1210,-719
8509,0,0,7,0,-7
8510,0,0,71,0,-71
8511,0,0,11,0,-11
8512,1,0,102,0,-102
8513,1,1,729,1599,870
8514,0,0,144,0,-144
8515,0,0,103,0,-103
8516,0,0,39,0,-39
8517,1,1,461,1358,897
8518,0,0,70,0,-70
8519,1,0,207,0,-207
8520,1,0,25,0,-25
8521,1,1,130,2146,2016
8522,0,0,65,0,-65
8523,0,0,9,0,-9
8524,0,0,113,0,-113
8525,1,1,1203,1305,102
8526,0,0,4,0,-4
8527,1,0,57,0,-57
8528,1,0,22,0,-22
8529,0,0,51,0,-51
8530,1,1,677,1818,1141
8531,1,0,34,0,-34
8532,1,1,67,1553,1486
8533,1,0,252,0,-252
8534,0,0,75,0,-75
8535,1,1,125,1719,1594
8536,1,1,1433,1273,-160
8537,1,1,507,1608,1101
8538,0,0,34,0,-34
8539,1,0,20,0,-20
8540,0,0,123,0,-123
8541,1,1,952,2454,1502
8542,0,0,69,0,-69
8543,1,0,121,0,-121
8544,1,1,1000,1487,487
8545,1,1,1243,1692,449
8546,1,1,176,1506,1330
8547,1,1,370,1323,953
8548,0,0,9,0,-9
8549,0,0,87,0,-87
8550,0,0,5,0,-5
8551,0,0,12,0,-12
8552,1,0,70,0,-70
8553,1,1,186,1676,1490
8554,1,0,64,0,-64
8555,1,0,90,0,-90
8556,1,0,11,0,-11
8557,0,0,28,0,-28
8558,1,1,545,1506,961
8559,0,0,12,0,-12
8560,0,0,5,0,-5
8561,1,0,9,0,-9
8562,1,0,41,0,-41
8563,1,0,36,0,-36
8564,1,0,87,0,-87
8565,1,0,73,0,-73
8566,1,1,1466,1319,-147
8567,1,0,1,0,-1
8568,1,1,880,1570,690
8569,1,1,145,1421,1276
8570,1,0,16,0,-16
8571,0,0,12,0,-12
8572,1,1,1001,1532,531
8573,0,0,5,0,-5
8574,0,0,53,0,-53
8575,0,0,14,0,-14
8576,1,1,452,1476,1024
8577,0,0,187,0,-187
8578,0,0,1,0,-1
8579,1,0,0,0,0
8580,1,1,52,1291,1239
8581,0,0,71,0,-71
8582,0,0,55,0,-55
8583,1,0,8,0,-8
8584,0,0,79,0,-79
8585,0,0,32,0,-32
8586,0,0,95,0,-95
8587,1,1,86,1820,1734
8588,1,0,159,0,-159
8589,1,1,1258,1466,208
8590,0,0,49,0,-49
8591,1,1,464,1467,1003
8592,1,1,178,1326,1148
8593,0,0,50,0,-50
8594,0,0,70,0,-70
8595,0,0,26,0,-26
8596,1,0,7,0,-7
8597,0,0,25,0,-25
8598,0,0,36,0,-36
8599,0,0,77,0,-77
8600,0,0,21,0,-21
8601,0,0,33,0,-33
8602,1,1,1611,1248,-363
8603,1,0,25,0,-25
8604,0,0,32,0,-32
8605,0,0,16,0,-16
8606,0,0,28,0,-28
8607,0,0,139,0,-139
8608,0,0,23,0,-23
8609,0,0,13,0,-13
8610,1,1,114,2356,2242
8611,0,0,34,0,-34
8612,1,0,34,0,-34
8613,1,0,49,0,-49
8614,1,1,1225,1940,715
8615,1,0,39,0,-39
8616,1,1,622,1544,922
8617,0,0,2,0,-2
8618,0,0,8,0,-8
8619,0,0,21,0,-21
8620,0,0,9,0,-9
8621,1,0,28,0,-28
8622,0,0,271,0,-271
8623,0,0,33,0,-33
8624,1,1,1503,1982,479
8625,1,0,65,0,-65
8626,1,1,545,1371,826
8627,1,1,179,1209,1030
8628,0,0,24,0,-24
8629,1,0,10,0,-10
8630,0,0,72,0,-72
8631,0,0,65,0,-65
8632,0,0,41,0,-41
8633,0,0,66,0,-66
8634,0,0,3,0,-3
8635,0,0,19,0,-19
8636,1,1,525,1890,1365
8637,1,1,214,1345,1131
8638,1,0,129,0,-129
8639,0,0,17,0,-17
8640,0,0,167,0,-167
8641,0,0,175,0,-175
8642,1,0,15,0,-15
8643,0,0,8,0,-8
8644,0,0,26,0,-26
8645,1,1,285,1203,918
8646,1,0,4,0,-4
8647,1,0,21,0,-21
8648,1,1,355,1281,926
8649,1,0,44,0,-44
8650,0,0,5,0,-5
8651,0,0,20,0,-20
8652,0,0,28,0,-28
8653,1,0,45,0,-45
8654,1,0,10,0,-10
8655,0,0,165,0,-165
8656,0,0,26,0,-26
8657,0,0,15,0,-15
8658,0,0,56,0,-56
8659,1,1,846,1336,490
8660,0,0,24,0,-24
8661,1,1,215,2306,2091
8662,1,0,217,0,-217
8663,1,1,1039,1228,189
8664,0,0,21,0,-21
8665,1,0,267,0,-267
8666,1,1,1399,1388,-11
8667,0,0,46,0,-46
8668,1,0,42,0,-42
8669,0,0,35,0,-35
8670,1,1,1041,1284,243
8671,0,0,2,0,-2
8672,1,1,517,1603,1086
8673,1,1,269,1450,1181
8674,1,1,230,1405,1175
8675,1,1,140,1228,1088
8676,1,0,103,0,-103
8677,1,0,47,0,-47
8678,1,0,76,0,-76
8679,0,0,6,0,-6
8680,1,1,359,2854,2495
8681,1,0,29,0,-29
8682,0,0,42,0,-42
8683,1,1,165,1402,1237
8684,0,0,4,0,-4
8685,1,0,9,0,-9
8686,0,0,197,0,-197
8687,0,0,8,0,-8
8688,1,0,8,0,-8
8689,0,0,52,0,-52
8690,0,0,23,0,-23
8691,1,0,86,0,-86
8692,0,0,43,0,-43
8693,0,0,21,0,-21
8694,1,0,13,0,-13
8695,1,0,14,0,-14
8696,0,0,72,0,-72
8697,0,0,214,0,-214
8698,1,0,61,0,-61
8699,0,0,146,0,-146
8700,1,0,42,0,-42
8701,0,0,4,0,-4
8702,0,0,13,0,-13
8703,1,1,126,1445,1319
8704,1,0,55,0,-55
8705,0,0,197,0,-197
8706,1,1,506,1304,798
8707,0,0,75,0,-75
8708,0,0,46,0,-46
8709,0,0,5,0,-5
8710,0,0,115,0,-115
8711,0,0,21,0,-21
8712,1,1,118,1321,1203
8713,1,1,229,1319,1090
8714,0,0,8,0,-8
8715,1,1,428,1845,1417
8716,1,0,106,0,-106
8717,1,1,763,1324,561
8718,1,1,399,1276,877
8719,1,0,55,0,-55
8720,1,1,626,2456,1830
8721,0,0,22,0,-22
8722,0,0,6,0,-6
8723,1,1,267,1549,1282
8724,0,0,4,0,-4
8725,0,0,21,0,-21
8726,1,1,681,1254,573
8727,0,0,111,0,-111
8728,0,0,30,0,-30
8729,0,0,31,0,-31
8730,0,0,56,0,-56
8731,1,0,47,0,-47
8732,0,0,27,0,-27
8733,1,0,34,0,-34
8734,1,1,64,1337,1273
8735,1,1,659,1228,569
8736,1,0,27,0,-27
8737,1,1,206,1239,1033
8738,1,1,2113,1436,-677
8739,1,0,26,0,-26
8740,1,1,494,1699,1205
8741,1,1,113,1301,1188
8742,1,1,319,1372,1053
8743,1,1,885,2230,1345
8744,0,0,37,0,-37
8745,1,0,30,0,-30
8746,0,0,178,0,-178
8747,1,1,204,1238,1034
8748,1,1,49,1503,1454
8749,0,0,58,0,-58
8750,1,0,81,0,-81
8751,1,0,67,0,-67
8752,0,0,19,0,-19
8753,1,1,759,1221,462
8754,0,0,28,0,-28
8755,1,0,6,0,-6
8756,0,0,115,0,-115
8757,1,1,266,1258,992
8758,1,1,320,1779,1459
8759,0,0,55,0,-55
8760,1,0,16,0,-16
8761,0,0,188,0,-188
8762,0,0,23,0,-23
8763,0,0,64,0,-64
8764,1,0,35,0,-35
8765,1,0,37,0,-37
8766,1,0,1,0,-1
8767,0,0,47,0,-47
8768,0,0,44,0,-44
8769,0,0,37,0,-37
8770,0,0,43,0,-43
8771,1,1,128,1504,1376
8772,1,1,333,1348,1015
8773,1,1,275,2311,2036
8774,1,0,5,0,-5
8775,1,0,72,0,-72
8776,1,1,151,1357,1206
8777,1,0,45,0,-45
8778,0,0,39,0,-39
8779,1,0,51,0,-51
8780,1,1,465,1674,1209
8781,0,0,32,0,-32
8782,1,0,48,0,-48
8783,1,0,77,0,-77
8784,1,0,50,0,-50
8785,1,1,448,1385,937
8786,0,0,87,0,-87
8787,0,0,7,0,-7
8788,1,0,14,0,-14
8789,1,0,33,0,-33
8790,0,0,105,0,-105
8791,1,1,288,2081,1793
8792,0,0,14,0,-14
8793,0,0,44,0,-44
8794,1,0,111,0,-111
8795,1,0,96,0,-96
8796,1,1,237,1449,1212
8797,0,0,69,0,-69
8798,1,1,779,1697,918
8799,1,0,1,0,-1
8800,0,0,202,0,-202
8801,1,0,47,0,-47
8802,1,0,14,0,-14
8803,1,1,110,1335,1225
8804,1,1,111,1675,1564
8805,0,0,21,0,-21
8806,1,1,109,1530,1421
8807,1,1,315,2260,1945
8808,0,0,12,0,-12
8809,1,0,25,0,-25
8810,1,1,138,1221,1083
8811,1,1,611,2025,1414
8812,1,1,840,1201,361
8813,0,0,2,0,-2
8814,1,0,0,0,0
8815,1,0,43,0,-43
8816,1,1,684,1628,944
8817,1,1,25,1355,1330
8818,1,1,400,1630,1230
8819,1,1,306,1585,1279
8820,1,0,2,0,-2
8821,1,1,290,1548,1258
8822,1,1,207,1344,1137
8823,1,0,1,0,-1
8824,1,1,430,1740,1310
8825,1,1,278,1849,1571
8826,0,0,77,0,-77
8827,1,1,217,1292,1075
8828,0,0,56,0,-56
8829,0,0,61,0,-61
8830,1,0,9,0,-9
8831,1,1,495,1291,796
8832,1,0,33,0,-33
8833,0,0,2,0,-2
8834,1,0,30,0,-30
8835,1,0,39,0,-39
8836,1,1,752,1598,846
8837,0,0,60,0,-60
8838,1,0,6,0,-6
8839,1,0,64,0,-64
8840,1,0,216,0,-216
8841,0,0,6,0,-6
8842,1,0,46,0,-46
8843,0,0,44,0,-44
8844,0,0,15,0,-15
8845,1,0,27,0,-27
8846,1,1,504,1370,866
8847,0,0,66,0,-66
8848,1,0,41,0,-41
8849,1,0,68,0,-68
8850,1,1,419,1421,1002
8851,0,0,102,0,-102
8852,1,1,9,1455,1446
8853,0,0,48,0,-48
8854,0,0,19,0,-19
8855,1,1,1191,1296,105
8856,1,1,751,1266,515
8857,1,1,240,1259,1019
8858,1,1,361,2456,2095
8859,1,0,168,0,-168
8860,0,0,6,0,-6
8861,0,0,76,0,-76
8862,1,1,189,1406,1217
8863,1,1,537,2044,1507
8864,1,0,11,0,-11
8865,1,0,32,0,-32
8866,1,0,54,0,-54
8867,1,0,3,0,-3
8868,0,0,12,0,-12
8869,0,0,65,0,-65
8870,0,0,8,0,-8
8871,0,0,32,0,-32
8872,1,0,47,0,-47
8873,0,0,48,0,-48
8874,0,0,55,0,-55
8875,0,0,44,0,-44
8876,1,1,1404,2421,1017
8877,0,0,36,0,-36
8878,0,0,97,0,-97
8879,0,0,176,0,-176
8880,0,0,14,0,-14
8881,1,0,106,0,-106
8882,1,1,551,2270,1719
8883,0,0,123,0,-123
8884,1,0,49,0,-49
8885,1,1,122,1557,1435
8886,1,1,981,1333,352
8887,1,1,939,1337,398
8888,1,1,257,1514,1257
8889,0,0,2,0,-2
8890,1,0,12,0,-12
8891,1,1,513,1850,1337
8892,1,0,40,0,-40
8893,0,0,61,0,-61
8894,1,0,20,0,-20
8895,1,1,106,1282,1176
8896,1,1,166,1734,1568
8897,1,0,47,0,-47
8898,0,0,92,0,-92
8899,1,0,35,0,-35
8900,1,0,25,0,-25
8901,1,0,8,0,-8
8902,1,1,80,1203,1123
8903,0,0,33,0,-33
8904,1,0,82,0,-82
8905,1,0,23,0,-23
8906,1,1,480,2408,1928
8907,0,0,1,0,-1
8908,1,1,322,1227,905
8909,0,0,59,0,-59
8910,1,0,51,0,-51
8911,1,1,54,1417,1363
8912,1,1,338,1467,1129
8913,0,0,151,0,-151
8914,0,0,12,0,-12
8915,0,0,24,0,-24
8916,1,1,2103,1544,-559
8917,1,1,94,2304,2210
8918,0,0,9,0,-9
8919,1,1,984,1806,822
8920,0,0,38,0,-38
8921,0,0,4,0,-4
8922,1,0,4,0,-4
8923,1,0,6,0,-6
8924,0,0,140,0,-140
8925,0,0,67,0,-67
8926,1,1,750,1485,735
8927,0,0,53,0,-53
8928,1,0,101,0,-101
8929,0,0,20,0,-20
8930,0,0,18,0,-18
8931,1,0,48,0,-48
8932,1,0,33,0,-33
8933,1,1,120,1476,1356
8934,0,0,38,0,-38
8935,0,0,5,0,-5
8936,0,0,39,0,-39
8937,0,0,6,0,-6
8938,1,1,1295,1591,296
8939,0,0,68,0,-68
8940,1,0,28,0,-28
8941,0,0,5,0,-5
8942,0,0,36,0,-36
8943,1,1,402,1493,1091
8944,1,1,131,1337,1206
8945,1,1,335,3060,2725
8946,1,0,30,0,-30
8947,0,0,21,0,-21
8948,1,0,25,0,-25
8949,0,0,115,0,-115
8950,1,1,395,1259,864
8951,1,0,68,0,-68
8952,1,1,183,1333,1150
8953,0,0,0,0,0
8954,1,0,20,0,-20
8955,1,0,0,0,0
8956,1,0,49,0,-49
8957,1,1,2128,1292,-836
8958,1,0,34,0,-34
8959,1,0,25,0,-25
8960,0,0,24,0,-24
8961,0,0,184,0,-184
8962,1,1,200,1307,1107
8963,0,0,10,0,-10
8964,1,1,33,1255,1222
8965,1,0,44,0,-44
8966,0,0,79,0,-79
8967,1,0,61,0,-61
8968,1,0,18,0,-18
8969,0,0,140,0,-140
8970,0,0,30,0,-30
8971,0,0,107,0,-107
8972,0,0,88,0,-88
8973,0,0,5,0,-5
8974,1,0,1,0,-1
8975,0,0,12,0,-12
8976,0,0,43,0,-43
8977,0,0,46,0,-46
8978,1,0,97,0,-97
8979,1,0,4,0,-4
8980,1,1,107,2251,2144
8981,1,0,26,0,-26
8982,0,0,19,0,-19
8983,1,0,62,0,-62
8984,1,0,191,0,-191
8985,0,0,84,0,-84
8986,1,0,19,0,-19
8987,1,1,89,1311,1222
8988,1,0,3,0,-3
8989,1,0,33,0,-33
8990,1,1,252,1654,1402
8991,0,0,4,0,-4
8992,0,0,6,0,-6
8993,0,0,27,0,-27
8994,0,0,295,0,-295
8995,1,0,130,0,-130
8996,1,0,356,0,-356
8997,1,0,25,0,-25
8998,0,0,35,0,-35
8999,1,1,248,1270,1022
9000,1,1,555,1257,702
9001,1,1,120,1592,1472
9002,0,0,0,0,0
9003,0,0,64,0,-64
9004,0,0,31,0,-31
9005,1,1,889,1372,483
9006,0,0,32,0,-32
9007,1,0,116,0,-116
9008,1,1,438,3346,2908
9009,0,0,42,0,-42
9010,0,0,8,0,-8
9011,0,0,23,0,-23
9012,0,0,58,0,-58
9013,1,1,634,1319,685
9014,1,0,62,0,-62
9015,1,0,78,0,-78
9016,1,1,323,1459,1136
9017,1,0,182,0,-182
9018,1,1,2001,3174,1173
9019,0,0,24,0,-24
9020,1,0,7,0,-7
9021,0,0,26,0,-26
9022,1,0,8,0,-8
9023,0,0,45,0,-45
9024,1,1,353,1209,856
9025,1,0,117,0,-117
9026,0,0,25,0,-25
9027,1,0,129,0,-129
9028,0,0,35,0,-35
9029,1,1,533,1609,1076
9030,1,0,0,0,0
9031,1,0,313,0,-313
9032,0,0,24,0,-24
9033,1,1,1101,1224,123
9034,0,0,80,0,-80
9035,1,0,1,0,-1
9036,0,0,89,0,-89
9037,0,0,188,0,-188
9038,1,0,48,0,-48
9039,0,0,133,0,-133
9040,1,0,137,0,-137
9041,1,1,201,2177,1976
9042,1,0,34,0,-34
9043,0,0,7,0,-7
9044,0,0,66,0,-66
9045,1,0,132,0,-132
9046,0,0,47,0,-47
9047,1,1,260,1250,990
9048,1,1,23,1822,1799
9049,1,1,144,1647,1503
9050,0,0,78,0,-78
9051,1,0,53,0,-53
9052,1,1,73,2206,2133
9053,1,1,136,2113,1977
9054,0,0,12,0,-12
9055,0,0,12,0,-12
9056,0,0,23,0,-23
9057,1,0,18,0,-18
9058,1,1,460,1407,947
9059,0,0,17,0,-17
9060,0,0,154,0,-154
9061,1,1,621,1277,656
9062,0,0,49,0,-49
9063,0,0,0,0,0
9064,1,0,11,0,-11
9065,1,1,50,1408,1358
9066,1,0,9,0,-9
9067,1,1,959,1296,337
9068,1,1,1470,1273,-197
9069,1,1,110,1288,1178
9070,0,0,31,0,-31
9071,1,0,21,0,-21
9072,1,1,31,1877,1846
9073,1,1,414,1550,1136
9074,1,0,53,0,-53
9075,1,1,594,1202,608
9076,1,1,806,1323,517
9077,0,0,7,0,-7
9078,1,1,103,1515,1412
9079,0,0,52,0,-52
9080,1,0,57,0,-57
9081,0,0,0,0,0
9082,1,0,34,0,-34
9083,1,1,60,1641,1581
9084,0,0,93,0,-93
9085,0,0,19,0,-19
9086,0,0,19,0,-19
9087,1,0,6,0,-6
9088,0,0,49,0,-49
9089,1,0,98,0,-98
9090,1,0,24,0,-24
9091,0,0,277,0,-277
9092,0,0,20,0,-20
9093,1,1,201,1618,1417
9094,0,0,42,0,-42
9095,1,0,130,0,-130
9096,1,1,17,1214,1197
9097,0,0,103,0,-103
9098,1,1,752,2397,1645
9099,1,1,94,1211,1117
9100,1,1,957,1657,700
9101,0,0,6,0,-6
9102,1,1,1081,1407,326
9103,1,0,40,0,-40
9104,0,0,55,0,-55
9105,0,0,25,0,-25
9106,1,1,56,2182,2126
9107,1,1,261,2384,2123
9108,0,0,132,0,-132
9109,1,1,381,1452,1071
9110,1,1,130,2010,1880
9111,0,0,38,0,-38
9112,1,0,8,0,-8
9113,0,0,45,0,-45
9114,0,0,1,0,-1
9115,1,1,813,1214,401
9116,1,0,14,0,-14
9117,0,0,21,0,-21
9118,1,0,33,0,-33
9119,1,1,383,1829,1446
9120,1,1,941,1427,486
9121,0,0,13,0,-13
9122,0,0,93,0,-93
9123,1,1,122,1307,1185
9124,1,0,8,0,-8
9125,1,0,22,0,-22
9126,0,0,165,0,-165
9127,1,0,14,0,-14
9128,0,0,8,0,-8
9129,0,0,4,0,-4
9130,1,0,15,0,-15
9131,0,0,117,0,-117
9132,1,0,3,0,-3
9133,0,0,66,0,-66
9134,0,0,51,0,-51
9135,1,0,34,0,-34
9136,1,1,266,1224,958
9137,1,1,100,1480,1380
9138,1,1,482,1559,1077
9139,0,0,132,0,-132
9140,1,0,30,0,-30
9141,0,0,39,0,-39
9142,1,1,102,1666,1564
9143,0,0,117,0,-117
9144,0,0,5,0,-5
9145,0,0,231,0,-231
9146,0,0,103,0,-103
9147,1,0,44,0,-44
9148,0,0,8,0,-8
9149,0,0,124,0,-124
9150,1,0,30,0,-30
9151,0,0,49,0,-49
9152,1,0,1,0,-1
9153,1,0,35,0,-35
9154,1,1,141,2048,1907
9155,1,1,134,2486,2352
9156,0,0,20,0,-20
9157,1,0,5,0,-5
9158,1,1,1172,1399,227
9159,1,1,585,1202,617
9160,0,0,19,0,-19
9161,1,1,1187,2211,1024
9162,1,0,165,0,-165
9163,1,0,199,0,-199
9164,0,0,23,0,-23
9165,1,0,0,0,0
9166,1,1,6268,1335,-4933
9167,1,1,581,2184,1603
9168,0,0,41,0,-41
9169,1,0,214,0,-214
9170,0,0,52,0,-52
9171,1,0,8,0,-8
9172,0,0,30,0,-30
9173,0,0,28,0,-28
9174,0,0,17,0,-17
9175,0,0,47,0,-47
9176,1,1,439,1261,822
9177,0,0,5,0,-5
9178,1,0,31,0,-31
9179,1,1,579,1241,662
9180,1,0,70,0,-70
9181,1,1,2007,1227,-780
9182,1,1,345,1664,1319
9183,0,0,68,0,-68
9184,0,0,1,0,-1
9185,1,1,386,1269,883
9186,0,0,137,0,-137
9187,1,1,150,1519,1369
9188,1,1,422,1338,916
9189,1,1,674,1274,600
9190,1,0,103,0,-103
9191,1,1,2267,1493,-774
9192,1,0,7,0,-7
9193,1,0,59,0,-59
9194,1,0,7,0,-7
9195,0,0,30,0,-30
9196,0,0,15,0,-15
9197,0,0,64,0,-64
9198,0,0,9,0,-9
9199,0,0,21,0,-21
9200,0,0,30,0,-30
9201,0,0,11,0,-11
9202,0,0,17,0,-17
9203,1,0,34,0,-34
9204,1,0,44,0,-44
9205,1,1,330,1229,899
9206,1,0,37,0,-37
9207,1,1,131,1249,1118
9208,0,0,1,0,-1
9209,1,0,14,0,-14
9210,1,0,16,0,-16
9211,1,1,412,1278,866
9212,1,1,189,1389,1200
9213,1,1,444,1405,961
9214,0,0,46,0,-46
9215,0,0,202,0,-202
9216,1,0,19,0,-19
9217,0,0,16,0,-16
9218,0,0,13,0,-13
9219,1,0,5,0,-5
9220,1,0,65,0,-65
9221,1,1,124,1485,1361
9222,0,0,92,0,-92
9223,1,1,401,1305,904
9224,1,1,2608,3321,713
9225,1,0,5,0,-5
9226,1,1,1217,1246,29
9227,0,0,46,0,-46
9228,1,0,10,0,-10
9229,1,1,570,1631,1061
9230,1,0,9,0,-9
9231,0,0,28,0,-28
9232,1,1,296,2799,2503
9233,1,1,420,1299,879
9234,1,1,699,1222,523
9235,0,0,62,0,-62
9236,0,0,122,0,-122
9237,1,1,141,1203,1062
9238,1,1,19,1295,1276
9239,1,0,10,0,-10
9240,0,0,71,0,-71
9241,1,1,544,1247,703
9242,1,1,287,1245,958
9243,1,0,63,0,-63
9244,1,0,52,0,-52
9245,0,0,225,0,-225
9246,0,0,15,0,-15
9247,1,0,33,0,-33
9248,0,0,4,0,-4
9249,1,1,78,1893,1815
9250,1,1,943,1225,282
9251,1,1,99,1335,1236
9252,1,1,925,1223,298
9253,1,1,1178,1663,485
9254,1,1,187,1797,1610
9255,1,1,1368,1381,13
9256,1,0,16,0,-16
9257,1,0,24,0,-24
9258,1,0,29,0,-29
9259,0,0,12,0,-12
9260,1,1,321,1338,1017
9261,1,1,721,1277,556
9262,0,0,21,0,-21
9263,0,0,234,0,-234
9264,0,0,14,0,-14
9265,1,0,8,0,-8
9266,0,0,76,0,-76
9267,1,1,404,1459,1055
9268,1,0,84,0,-84
9269,1,0,162,0,-162
9270,1,0,138,0,-138
9271,1,1,493,1698,1205
9272,1,0,107,0,-107
9273,0,0,127,0,-127
9274,0,0,59,0,-59
9275,0,0,9,0,-9
9276,0,0,30,0,-30
9277,0,0,20,0,-20
9278,0,0,82,0,-82
9279,0,0,55,0,-55
9280,0,0,83,0,-83
9281,1,0,12,0,-12
9282,0,0,33,0,-33
9283,1,1,800,1729,929
9284,1,0,95,0,-95
9285,0,0,0,0,0
9286,1,0,30,0,-30
9287,0,0,54,0,-54
9288,1,1,430,1431,1001
9289,0,0,100,0,-100
9290,0,0,34,0,-34
9291,0,0,66,0,-66
9292,0,0,18,0,-18
9293,0,0,5,0,-5
9294,0,0,22,0,-22
9295,1,0,14,0,-14
9296,0,0,94,0,-94
9297,1,1,308,1335,1027
9298,0,0,18,0,-18
9299,1,1,1416,1224,-192
9300,1,0,32,0,-32
9301,0,0,28,0,-28
9302,1,1,847,1323,476
9303,1,0,37,0,-37
9304,1,1,59,1414,1355
9305,1,1,948,1216,268
9306,1,1,1253,1539,286
9307,0,0,68,0,-68
9308,0,0,101,0,-101
9309,1,1,328,1250,922
9310,1,0,42,0,-42
9311,1,1,150,1646,1496
9312,1,1,71,1232,1161
9313,1,0,5,0,-5
9314,0,0,53,0,-53
9315,1,1,702,1421,719
9316,1,0,20,0,-20
9317,0,0,43,0,-43
9318,0,0,59,0,-59
9319,0,0,88,0,-88
9320,1,0,11,0,-11
9321,1,1,173,1380,1207
9322,1,1,24,1376,1352
9323,1,1,1861,1737,-124
9324,1,0,5,0,-5
9325,1,0,19,0,-19
9326,1,0,11,0,-11
9327,1,1,377,1260,883
9328,0,0,63,0,-63
9329,0,0,10,0,-10
9330,1,1,61,2943,2882
9331,1,0,2,0,-2
9332,1,0,109,0,-109
9333,1,1,349,1405,1056
9334,1,1,184,1769,1585
9335,0,0,5,0,-5
9336,1,1,65,3119,3054
9337,1,0,65,0,-65
9338,1,0,29,0,-29
9339,1,0,49,0,-49
9340,1,0,46,0,-46
9341,1,0,85,0,-85
9342,1,1,572,1221,649
9343,1,1,871,1490,619
9344,1,1,1326,1986,660
9345,0,0,9,0,-9
9346,1,0,2,0,-2
9347,1,1,280,1289,1009
9348,1,0,70,0,-70
9349,1,0,7,0,-7
9350,0,0,0,0,0
9351,0,0,24,0,-24
9352,0,0,19,0,-19
9353,1,0,8,0,-8
9354,0,0,37,0,-37
9355,0,0,52,0,-52
9356,1,0,65,0,-65
9357,0,0,16,0,-16
9358,1,1,448,3039,2591
9359,0,0,7,0,-7
9360,1,0,61,0,-61
9361,1,0,73,0,-73
9362,1,0,10,0,-10
9363,1,0,18,0,-18
9364,1,0,72,0,-72
9365,0,0,99,0,-99
9366,1,0,19,0,-19
9367,1,0,23,0,-23
9368,1,1,1735,1237,-498
9369,1,0,119,0,-119
9370,1,1,231,1787,1556
9371,1,1,134,1461,1327
9372,0,0,25,0,-25
9373,1,1,571,1264,693
9374,0,0,23,0,-23
9375,0,0,34,0,-34
9376,0,0,76,0,-76
9377,1,1,343,1335,992
9378,1,1,1327,1399,72
9379,1,1,516,1700,1184
9380,1,0,0,0,0
9381,1,0,167,0,-167
9382,1,0,1,0,-1
9383,1,0,19,0,-19
9384,1,0,20,0,-20
9385,1,0,91,0,-91
9386,1,0,23,0,-23
9387,0,0,84,0,-84
9388,1,1,909,1213,304
9389,1,1,364,1372,1008
9390,0,0,49,0,-49
9391,1,0,1,0,-1
9392,1,0,54,0,-54
9393,1,1,918,1664,746
9394,0,0,11,0,-11
9395,0,0,3,0,-3
9396,0,0,49,0,-49
9397,1,0,62,0,-62
9398,1,0,111,0,-111
9399,0,0,103,0,-103
9400,1,0,9,0,-9
9401,1,1,339,1969,1630
9402,1,1,1447,1416,-31
9403,1,1,832,1804,972
9404,1,1,521,2316,1795
9405,1,1,346,1205,859
9406,1,1,49,1208,1159
9407,0,0,47,0,-47
9408,0,0,15,0,-15
9409,1,1,913,2089,1176
9410,1,0,87,0,-87
9411,1,1,385,1343,958
9412,1,1,147,1261,1114
9413,1,0,27,0,-27
9414,0,0,17,0,-17
9415,1,0,79,0,-79
9416,0,0,14,0,-14
9417,1,0,25,0,-25
9418,1,1,267,1641,1374
9419,1,1,383,1365,982
9420,1,0,61,0,-61
9421,1,1,256,1469,1213
9422,1,1,658,3271,2613
9423,1,0,99,0,-99
9424,1,0,25,0,-25
9425,1,0,18,0,-18
9426,1,0,29,0,-29
9427,1,0,12,0,-12
9428,1,0,18,0,-18
9429,1,1,1084,1367,283
9430,1,1,986,1295,309
9431,0,0,43,0,-43
9432,1,1,549,1438,889
9433,0,0,4,0,-4
9434,0,0,39,0,-39
9435,1,0,32,0,-32
9436,1,0,5,0,-5
9437,1,1,124,1251,1127
9438,1,0,51,0,-51
9439,0,0,35,0,-35
9440,1,0,10,0,-10
9441,0,0,34,0,-34
9442,0,0,25,0,-25
9443,0,0,62,0,-62
9444,1,1,2407,1503,-904
9445,1,1,1485,2248,763
9446,1,0,31,0,-31
9447,1,1,375,1274,899
9448,1,1,1256,1418,162
9449,1,0,50,0,-50
9450,0,0,159,0,-159
9451,1,0,80,0,-80
9452,1,1,706,1760,1054
9453,0,0,51,0,-51
9454,1,1,49,1304,1255
9455,1,1,22,1469,1447
9456,1,1,1132,1256,124
9457,0,0,13,0,-13
9458,1,1,630,1374,744
9459,0,0,8,0,-8
9460,0,0,5,0,-5
9461,1,1,140,1814,1674
9462,1,1,913,1560,647
9463,1,0,33,0,-33
9464,1,0,59,0,-59
9465,1,1,154,5225,5071
9466,1,1,138,1223,1085
9467,0,0,11,0,-11
9468,1,1,106,1467,1361
9469,1,1,318,1226,908
9470,1,1,307,2161,1854
9471,0,0,212,0,-212
9472,1,0,8,0,-8
9473,0,0,16,0,-16
9474,1,1,413,1276,863
9475,0,0,110,0,-110
9476,1,0,9,0,-9
9477,1,1,692,1232,540
9478,1,0,7,0,-7
9479,1,0,59,0,-59
9480,0,0,2,0,-2
9481,0,0,7,0,-7
9482,1,1,169,1285,1116
9483,1,1,328,1367,1039
9484,1,0,78,0,-78
9485,1,1,399,1836,1437
9486,0,0,13,0,-13
9487,1,1,731,1334,603
9488,1,1,1606,1263,-343
9489,1,0,12,0,-12
9490,0,0,39,0,-39
9491,1,0,16,0,-16
9492,0,0,35,0,-35
9493,0,0,30,0,-30
9494,1,0,1,0,-1
9495,0,0,33,0,-33
9496,0,0,58,0,-58
9497,0,0,38,0,-38
9498,1,0,79,0,-79
9499,1,0,52,0,-52
9500,0,0,18,0,-18
9501,1,1,729,1225,496
9502,0,0,0,0,0
9503,0,0,27,0,-27
9504,1,0,30,0,-30
9505,1,0,33,0,-33
9506,1,0,5,0,-5
9507,0,0,135,0,-135
9508,0,0,19,0,-19
9509,1,0,11,0,-11
9510,0,0,21,0,-21
9511,0,0,23,0,-23
9512,0,0,23,0,-23
9513,1,0,6,0,-6
9514,0,0,19,0,-19
9515,1,0,26,0,-26
9516,1,0,11,0,-11
9517,1,0,95,0,-95
9518,1,1,336,1437,1101
9519,1,0,68,0,-68
9520,1,0,12,0,-12
9521,1,0,17,0,-17
9522,1,1,392,1433,1041
9523,0,0,35,0,-35
9524,1,1,542,1204,662
9525,1,0,17,0,-17
9526,0,0,52,0,-52
9527,1,1,733,1261,528
9528,1,1,140,1770,1630
9529,0,0,138,0,-138
9530,0,0,33,0,-33
9531,1,0,2,0,-2
9532,1,1,57,1306,1249
9533,1,0,90,0,-90
9534,0,0,54,0,-54
9535,0,0,24,0,-24
9536,1,0,2,0,-2
9537,0,0,58,0,-58
9538,0,0,21,0,-21
9539,0,0,94,0,-94
9540,0,0,3,0,-3
9541,1,0,18,0,-18
9542,1,0,39,0,-39
9543,1,0,32,0,-32
9544,1,1,334,1703,1369
9545,1,0,84,0,-84
9546,0,0,13,0,-13
9547,1,1,91,1400,1309
9548,1,1,200,1447,1247
9549,1,0,37,0,-37
9550,1,1,303,1367,1064
9551,1,0,17,0,-17
9552,0,0,28,0,-28
9553,1,0,16,0,-16
9554,1,0,77,0,-77
9555,0,0,1,0,-1
9556,1,0,2,0,-2
9557,1,1,237,1521,1284
9558,0,0,47,0,-47
9559,0,0,15,0,-15
9560,0,0,32,0,-32
9561,1,0,26,0,-26
9562,0,0,8,0,-8
9563,0,0,129,0,-129
9564,0,0,18,0,-18
9565,1,0,4,0,-4
9566,1,0,71,0,-71
9567,0,0,47,0,-47
9568,0,0,117,0,-117
9569,0,0,23,0,-23
9570,1,0,79,0,-79
9571,0,0,114,0,-114
9572,1,1,41,2163,2122
9573,0,0,117,0,-117
9574,1,1,256,1538,1282
9575,1,0,39,0,-39
9576,1,0,18,0,-18
9577,1,1,163,1228,1065
9578,1,0,20,0,-20
9579,0,0,5,0,-5
9580,1,0,149,0,-149
9581,1,1,3167,5910,2743
9582,1,0,44,0,-44
9583,1,1,102,1285,1183
9584,1,0,18,0,-18
9585,0,0,31,0,-31
9586,1,0,31,0,-31
9587,1,0,76,0,-76
9588,0,0,3,0,-3
9589,1,0,8,0,-8
9590,1,1,91,1391,1300
9591,1,1,149,2799,2650
9592,1,0,21,0,-21
9593,0,0,6,0,-6
9594,0,0,2,0,-2
9595,1,1,381,1590,1209
9596,1,0,51,0,-51
9597,1,0,71,0,-71
9598,1,0,49,0,-49
9599,1,1,2093,1923,-170
9600,0,0,23,0,-23
9601,1,0,10,0,-10
9602,1,0,38,0,-38
9603,0,0,12,0,-12
9604,0,0,63,0,-63
9605,1,1,55,1862,1807
9606,1,1,267,1322,1055
9607,1,1,907,1223,316
9608,0,0,22,0,-22
9609,0,0,36,0,-36
9610,1,0,36,0,-36
9611,0,0,11,0,-11
9612,1,1,139,1242,1103
9613,0,0,61,0,-61
9614,1,1,716,1589,873
9615,0,0,44,0,-44
9616,1,1,51,1484,1433
9617,0,0,8,0,-8
9618,0,0,61,0,-61
9619,0,0,85,0,-85
9620,0,0,92,0,-92
9621,1,0,39,0,-39
9622,0,0,16,0,-16
9623,0,0,121,0,-121
9624,0,0,24,0,-24
9625,1,0,86,0,-86
9626,0,0,7,0,-7
9627,0,0,1,0,-1
9628,0,0,3,0,-3
9629,1,1,658,1411,753
9630,0,0,144,0,-144
9631,0,0,34,0,-34
9632,0,0,6,0,-6
9633,0,0,219,0,-219
9634,0,0,5,0,-5
9635,1,1,294,1518,1224
9636,1,1,301,1394,1093
9637,1,1,680,2525,1845
9638,0,0,24,0,-24
9639,1,0,78,0,-78
9640,1,1,291,1201,910
9641,1,1,23,1209,1186
9642,0,0,54,0,-54
9643,1,0,55,0,-55
9644,0,0,19,0,-19
9645,1,0,10,0,-10
9646,0,0,29,0,-29
9647,1,0,61,0,-61
9648,0,0,224,0,-224
9649,0,0,36,0,-36
9650,1,0,35,0,-35
9651,0,0,107,0,-107
9652,1,1,870,1415,545
9653,1,1,351,1409,1058
9654,1,0,168,0,-168
9655,1,0,4,0,-4
9656,0,0,44,0,-44
9657,0,0,73,0,-73
9658,0,0,134,0,-134
9659,1,0,88,0,-88
9660,0,0,8,0,-8
9661,0,0,75,0,-75
9662,1,1,87,1530,1443
9663,0,0,156,0,-156
9664,0,0,19,0,-19
9665,0,0,32,0,-32
9666,0,0,3,0,-3
9667,0,0,6,0,-6
9668,1,1,71,1698,1627
9669,0,0,112,0,-112
9670,1,0,27,0,-27
9671,1,1,573,1573,1000
9672,1,0,74,0,-74
9673,0,0,1,0,-1
9674,1,0,18,0,-18
9675,1,1,102,2187,2085
9676,1,1,663,1262,599
9677,1,0,32,0,-32
9678,1,1,1236,1220,-16
9679,1,0,78,0,-78
9680,0,0,42,0,-42
9681,0,0,17,0,-17
9682,1,1,113,2510,2397
9683,1,0,35,0,-35
9684,0,0,10,0,-10
9685,1,0,40,0,-40
9686,1,0,3,0,-3
9687,1,0,101,0,-101
9688,0,0,53,0,-53
9689,1,1,49,1412,1363
9690,1,1,635,1209,574
9691,0,0,122,0,-122
9692,0,0,25,0,-25
9693,1,1,63,1494,1431
9694,1,0,10,0,-10
9695,1,0,23,0,-23
9696,1,0,207,0,-207
9697,1,1,348,1488,1140
9698,1,0,37,0,-37
9699,0,0,92,0,-92
9700,0,0,3,0,-3
9701,0,0,1,0,-1
9702,1,1,326,1603,1277
9703,0,0,42,0,-42
9704,1,0,6,0,-6
9705,1,1,434,1260,826
9706,1,0,151,0,-151
9707,0,0,27,0,-27
9708,0,0,41,0,-41
9709,0,0,9,0,-9
9710,1,1,40,1387,1347
9711,1,0,173,0,-173
9712,1,0,47,0,-47
9713,1,0,74,0,-74
9714,0,0,43,0,-43
9715,1,0,62,0,-62
9716,1,1,1263,1530,267
9717,0,0,20,0,-20
9718,1,0,68,0,-68
9719,0,0,21,0,-21
9720,0,0,36,0,-36
9721,0,0,17,0,-17
9722,0,0,45,0,-45
9723,1,0,51,0,-51
9724,0,0,57,0,-57
9725,1,0,37,0,-37
9726,1,1,459,1238,779
9727,1,0,43,0,-43
9728,0,0,46,0,-46
9729,1,0,24,0,-24
9730,0,0,144,0,-144
9731,0,0,147,0,-147
9732,0,0,26,0,-26
9733,0,0,15,0,-15
9734,1,1,151,1586,1435
9735,0,0,3,0,-3
9736,1,0,32,0,-32
9737,1,1,221,1461,1240
9738,0,0,0,0,0
9739,0,0,31,0,-31
9740,0,0,171,0,-171
9741,0,0,0,0,0
9742,1,0,10,0,-10
9743,1,1,1281,1209,-72
9744,0,0,76,0,-76
9745,1,0,17,0,-17
9746,1,1,1864,1232,-632
9747,1,1,879,1501,622
9748,1,0,71,0,-71
9749,1,1,740,1593,853
9750,1,0,69,0,-69
9751,0,0,18,0,-18
9752,1,1,624,1210,586
9753,1,1,303,1458,1155
9754,1,1,727,1388,661
9755,1,0,4,0,-4
9756,1,0,2,0,-2
9757,0,0,12,0,-12
9758,0,0,19,0,-19
9759,0,0,10,0,-10
9760,1,0,94,0,-94
9761,0,0,92,0,-92
9762,0,0,21,0,-21
9763,0,0,23,0,-23
9764,1,0,73,0,-73
9765,1,0,14,0,-14
9766,1,0,131,0,-131
9767,1,0,4,0,-4
9768,1,0,21,0,-21
9769,0,0,8,0,-8
9770,0,0,42,0,-42
9771,1,0,2,0,-2
9772,0,0,22,0,-22
9773,0,0,8,0,-8
9774,0,0,35,0,-35
9775,0,0,36,0,-36
9776,0,0,143,0,-143
9777,1,0,125,0,-125
9778,1,1,203,1493,1290
9779,1,1,843,1419,576
9780,1,1,929,1353,424
9781,1,1,165,1325,1160
9782,0,0,27,0,-27
9783,1,0,19,0,-19
9784,0,0,65,0,-65
9785,0,0,23,0,-23
9786,0,0,12,0,-12
9787,1,1,876,1469,593
9788,1,0,141,0,-141
9789,1,1,23,1715,1692
9790,1,1,542,2101,1559
9791,0,0,37,0,-37
9792,0,0,11,0,-11
9793,1,1,262,1244,982
9794,0,0,81,0,-81
9795,1,1,1191,3969,2778
9796,1,0,22,0,-22
9797,1,1,350,1232,882
9798,0,0,19,0,-19
9799,0,0,30,0,-30
9800,1,0,17,0,-17
9801,1,0,4,0,-4
9802,0,0,130,0,-130
9803,1,0,42,0,-42
9804,0,0,68,0,-68
9805,0,0,87,0,-87
9806,0,0,24,0,-24
9807,1,0,1,0,-1
9808,0,0,108,0,-108
9809,1,0,35,0,-35
9810,0,0,15,0,-15
9811,1,0,3,0,-3
9812,1,0,52,0,-52
9813,1,1,6,1368,1362
9814,0,0,50,0,-50
9815,1,1,1197,1984,787
9816,1,0,19,0,-19
9817,1,1,262,1216,954
9818,0,0,5,0,-5
9819,0,0,4,0,-4
9820,1,0,15,0,-15
9821,0,0,8,0,-8
9822,0,0,11,0,-11
9823,0,0,15,0,-15
9824,0,0,35,0,-35
9825,1,1,122,1241,1119
9826,1,1,598,1613,1015
9827,0,0,22,0,-22
9828,1,0,65,0,-65
9829,1,1,222,1424,1202
9830,1,0,4,0,-4
9831,1,0,8,0,-8
9832,1,0,22,0,-22
9833,1,0,4,0,-4
9834,1,0,15,0,-15
9835,1,1,539,1357,818
9836,0,0,5,0,-5
9837,0,0,82,0,-82
9838,1,1,522,1604,1082
9839,1,0,19,0,-19
9840,1,0,16,0,-16
9841,1,1,1053,1387,334
9842,1,1,469,1878,1409
9843,0,0,101,0,-101
9844,0,0,100,0,-100
9845,1,1,332,1452,1120
9846,1,1,728,1332,604
9847,1,1,480,1709,1229
9848,0,0,9,0,-9
9849,0,0,75,0,-75
9850,0,0,42,0,-42
9851,1,1,205,1417,1212
9852,1,1,322,2429,2107
9853,0,0,1,0,-1
9854,1,0,91,0,-91
9855,1,1,1441,1211,-230
9856,1,0,15,0,-15
9857,0,0,6,0,-6
9858,1,1,262,1395,1133
9859,0,0,11,0,-11
9860,1,0,51,0,-51
9861,0,0,49,0,-49
9862,1,1,10,1453,1443
9863,1,0,95,0,-95
9864,1,1,271,1369,1098
9865,0,0,14,0,-14
9866,0,0,29,0,-29
9867,1,1,251,1208,957
9868,1,1,324,1962,1638
9869,1,1,213,1691,1478
9870,0,0,37,0,-37
9871,1,1,137,1346,1209
9872,1,0,66,0,-66
9873,0,0,11,0,-11
9874,0,0,38,0,-38
9875,1,1,272,1653,1381
9876,1,1,82,1253,1171
9877,0,0,43,0,-43
9878,0,0,12,0,-12
9879,1,1,897,2202,1305
9880,0,0,54,0,-54
9881,0,0,26,0,-26
9882,0,0,19,0,-19
9883,1,0,64,0,-64
9884,1,1,507,1571,1064
9885,0,0,9,0,-9
9886,0,0,53,0,-53
9887,1,1,407,1804,1397
9888,0,0,33,0,-33
9889,0,0,104,0,-104
9890,1,0,259,0,-259
9891,0,0,89,0,-89
9892,1,0,3,0,-3
9893,1,0,50,0,-50
9894,1,1,114,1614,1500
9895,0,0,26,0,-26
9896,1,1,603,1840,1237
9897,1,1,1845,1810,-35
9898,1,0,75,0,-75
9899,0,0,24,0,-24
9900,0,0,69,0,-69
9901,1,1,301,1544,1243
9902,0,0,49,0,-49
9903,0,0,16,0,-16
9904,0,0,15,0,-15
9905,0,0,71,0,-71
9906,1,0,15,0,-15
9907,1,1,301,1448,1147
9908,0,0,17,0,-17
9909,1,1,3100,1214,-1886
9910,0,0,42,0,-42
9911,0,0,0,0,0
9912,1,1,652,1974,1322
9913,1,1,1906,1385,-521
9914,1,0,66,0,-66
9915,0,0,13,0,-13
9916,0,0,123,0,-123
9917,0,0,49,0,-49
9918,1,0,8,0,-8
9919,1,1,519,1959,1440
9920,1,0,14,0,-14
9921,0,0,2,0,-2
9922,1,0,5,0,-5
9923,0,0,76,0,-76
9924,1,1,804,1744,940
9925,0,0,240,0,-240
9926,0,0,19,0,-19
9927,1,0,9,0,-9
9928,1,1,890,1216,326
9929,0,0,16,0,-16
9930,1,0,14,0,-14
9931,0,0,64,0,-64
9932,1,0,72,0,-72
9933,1,0,120,0,-120
9934,1,0,26,0,-26
9935,1,1,134,1329,1195
9936,1,0,162,0,-162
9937,1,0,65,0,-65
9938,1,1,2097,1413,-684
9939,1,0,43,0,-43
9940,0,0,46,0,-46
9941,1,0,40,0,-40
9942,0,0,0,0,0
9943,1,1,16,1878,1862
9944,1,0,25,0,-25
9945,0,0,8,0,-8
9946,1,0,19,0,-19
9947,1,0,4,0,-4
9948,1,1,129,1356,1227
9949,1,0,17,0,-17
9950,1,0,0,0,0
9951,0,0,10,0,-10
9952,0,0,7,0,-7
9953,1,1,349,1540,1191
9954,1,1,131,1923,1792
9955,0,0,30,0,-30
9956,1,0,56,0,-56
9957,1,0,36,0,-36
9958,1,1,393,1244,851
9959,0,0,41,0,-41
9960,1,0,27,0,-27
9961,1,1,378,4015,3637
9962,1,0,83,0,-83
9963,1,1,203,1507,1304
9964,0,0,27,0,-27
9965,0,0,144,0,-144
9966,1,0,169,0,-169
9967,0,0,31,0,-31
9968,0,0,57,0,-57
9969,1,0,73,0,-73
9970,1,0,47,0,-47
9971,1,1,497,1333,836
9972,1,1,482,1598,1116
9973,0,0,50,0,-50
9974,1,1,432,1394,962
9975,1,0,64,0,-64
9976,1,0,194,0,-194
9977,1,0,69,0,-69
9978,1,1,103,4421,4318
9979,0,0,12,0,-12
9980,1,0,34,0,-34
9981,1,0,23,0,-23
9982,1,1,541,1587,1046
9983,1,1,345,1576,1231
9984,0,0,11,0,-11
9985,1,1,10,1954,1944
9986,0,0,104,0,-104
9987,0,0,17,0,-17
9988,1,1,436,1461,1025
9989,1,1,135,1291,1156
9990,0,0,8,0,-8
9991,1,1,304,1647,1343
9992,1,0,30,0,-30
9993,0,0,122,0,-122
9994,1,1,338,1277,939
9995,1,0,92,0,-92
9996,1,1,1793,1381,-412
9997,1,1,228,1610,1382
9998,0,0,64,0,-64
9999,1,1,207,1359,1152
10000,1,1,533,1354,821
10001,1,0,42,0,-42
10002,1,1,481,1319,838
10003,1,1,273,1291,1018
10004,1,1,221,1246,1025
10005,1,1,161,1292,1131
10006,0,0,63,0,-63
10007,1,1,1452,1312,-140
10008,0,0,4,0,-4
10009,0,0,33,0,-33
10010,0,0,1,0,-1
10011,1,0,10,0,-10
10012,0,0,19,0,-19
10013,0,0,103,0,-103
10014,1,1,919,1292,373
10015,0,0,3,0,-3
10016,1,1,236,1628,1392
10017,1,0,25,0,-25
10018,0,0,13,0,-13
10019,0,0,21,0,-21
10020,0,0,90,0,-90
10021,1,1,359,1737,1378
10022,1,0,35,0,-35
10023,0,0,19,0,-19
10024,0,0,8,0,-8
10025,1,0,11,0,-11
10026,0,0,146,0,-146
10027,1,1,111,1441,1330
10028,1,1,14,1741,1727
10029,1,0,10,0,-10
10030,1,0,66,0,-66
10031,1,0,89,0,-89
10032,1,1,355,1238,883
10033,0,0,10,0,-10
10034,1,1,345,1247,902
10035,0,0,30,0,-30
10036,0,0,35,0,-35
10037,0,0,96,0,-96
10038,1,0,117,0,-117
10039,0,0,7,0,-7
10040,0,0,5,0,-5
10041,1,1,931,1343,412
10042,0,0,36,0,-36
10043,1,1,773,1428,655
10044,1,1,208,1897,1689
10045,1,0,17,0,-17
10046,1,1,1030,1577,547
10047,1,1,445,1444,999
10048,1,0,72,0,-72
10049,1,0,27,0,-27
10050,0,0,43,0,-43
10051,0,0,0,0,0
10052,1,0,72,0,-72
10053,0,0,99,0,-99
10054,1,0,153,0,-153
10055,1,1,1419,1717,298
10056,0,0,26,0,-26
10057,1,1,727,1293,566
10058,1,0,140,0,-140
10059,1,1,745,2046,1301
10060,0,0,32,0,-32
10061,1,0,17,0,-17
10062,1,0,31,0,-31
10063,0,0,23,0,-23
10064,0,0,42,0,-42
10065,0,0,148,0,-148
10066,0,0,113,0,-113
10067,1,0,111,0,-111
10068,1,0,13,0,-13
10069,1,0,37,0,-37
10070,0,0,25,0,-25
10071,1,0,14,0,-14
10072,1,1,635,4370,3735
10073,1,1,15,1684,1669
10074,0,0,13,0,-13
10075,1,0,36,0,-36
10076,1,1,278,1442,1164
10077,1,1,284,1394,1110
10078,1,0,17,0,-17
10079,1,1,337,1781,1444
10080,0,0,84,0,-84
10081,0,0,64,0,-64
10082,1,1,250,2172,1922
10083,1,1,574,1241,667
10084,1,0,80,0,-80
10085,1,0,43,0,-43
10086,0,0,12,0,-12
10087,1,1,125,1209,1084
10088,0,0,138,0,-138
10089,0,0,33,0,-33
10090,0,0,7,0,-7
10091,1,0,23,0,-23
10092,0,0,9,0,-9
10093,0,0,104,0,-104
10094,0,0,44,0,-44
10095,1,1,906,1663,757
10096,1,1,469,1507,1038
10097,1,1,1074,2305,1231
10098,1,0,18,0,-18
10099,1,1,561,1578,1017
10100,0,0,57,0,-57
10101,0,0,7,0,-7
10102,0,0,5,0,-5
10103,0,0,10,0,-10
10104,1,1,903,1271,368
10105,1,0,1,0,-1
10106,0,0,62,0,-62
10107,1,1,184,1316,1132
10108,1,0,0,0,0
10109,0,0,76,0,-76
10110,1,1,26,1366,1340
10111,1,1,463,1532,1069
10112,0,0,116,0,-116
10113,0,0,140,0,-140
10114,0,0,95,0,-95
10115,1,1,246,1298,1052
10116,1,1,749,1283,534
10117,1,0,33,0,-33
10118,1,0,167,0,-167
10119,1,1,114,1321,1207
10120,1,0,5,0,-5
10121,1,1,425,1341,916
10122,0,0,35,0,-35
10123,1,1,225,1258,1033
10124,1,1,593,1200,607
10125,0,0,173,0,-173
10126,1,0,34,0,-34
10127,1,1,846,1335,489
10128,1,1,167,1238,1071
10129,1,1,845,1227,382
10130,0,0,9,0,-9
10131,1,0,7,0,-7
10132,1,1,191,1577,1386
10133,1,0,72,0,-72
10134,0,0,29,0,-29
10135,1,1,144,1245,1101
10136,0,0,11,0,-11
10137,0,0,143,0,-143
10138,1,0,15,0,-15
10139,1,1,801,1413,612
10140,1,1,88,1418,1330
10141,0,0,108,0,-108
10142,0,0,0,0,0
10143,1,0,176,0,-176
10144,1,1,372,5100,4728
10145,1,1,1024,1246,222
10146,1,0,35,0,-35
10147,1,0,45,0,-45
10148,1,1,89,1663,1574
10149,1,1,517,1612,1095
10150,1,1,1018,1321,303
10151,1,1,454,2165,1711
10152,0,0,128,0,-128
10153,1,0,4,0,-4
10154,0,0,4,0,-4
10155,1,1,231,1601,1370
10156,0,0,41,0,-41
10157,1,1,41,1565,1524
10158,0,0,34,0,-34
10159,0,0,6,0,-6
10160,0,0,30,0,-30
10161,1,1,760,2012,1252
10162,1,0,8,0,-8
10163,1,1,150,1233,1083
10164,1,1,1446,1298,-148
10165,0,0,163,0,-163
10166,0,0,21,0,-21
10167,1,0,5,0,-5
10168,1,1,822,1449,627
10169,1,0,55,0,-55
10170,0,0,13,0,-13
10171,1,0,29,0,-29
10172,1,1,1536,1350,-186
10173,0,0,155,0,-155
10174,1,0,74,0,-74
10175,0,0,24,0,-24
10176,0,0,93,0,-93
10177,0,0,28,0,-28
10178,1,1,1643,1964,321
10179,0,0,27,0,-27
10180,1,0,85,0,-85
10181,1,1,1217,2058,841
10182,0,0,35,0,-35
10183,1,0,11,0,-11
10184,1,1,113,1320,1207
10185,1,1,645,1313,668
10186,0,0,0,0,0
10187,1,1,711,1453,742
10188,1,1,259,1246,987
10189,1,1,176,2055,1879
10190,0,0,33,0,-33
10191,1,0,0,0,0
10192,1,0,30,0,-30
10193,1,0,52,0,-52
10194,1,1,335,1307,972
10195,1,1,715,1352,637
10196,1,1,85,1933,1848
10197,1,0,5,0,-5
10198,0,0,99,0,-99
10199,1,1,797,1698,901
10200,1,1,216,1302,1086
10201,1,0,146,0,-146
10202,1,1,280,1329,1049
10203,1,1,41,1254,1213
10204,0,0,76,0,-76
10205,1,0,67,0,-67
10206,0,0,167,0,-167
10207,1,1,172,1468,1296
10208,0,0,26,0,-26
10209,0,0,32,0,-32
10210,1,1,73,2355,2282
10211,1,1,574,1804,1230
10212,1,1,845,1676,831
10213,0,0,24,0,-24
10214,1,1,721,2034,1313
10215,1,0,34,0,-34
10216,1,1,447,1271,824
10217,1,1,758,1264,506
10218,1,1,336,1285,949
10219,0,0,167,0,-167
10220,0,0,61,0,-61
10221,0,0,14,0,-14
10222,0,0,73,0,-73
10223,1,1,12,2238,2226
10224,0,0,22,0,-22
10225,1,1,298,1976,1678
10226,1,1,624,1225,601
10227,1,0,51,0,-51
10228,1,1,67,1628,1561
10229,1,0,75,0,-75
10230,1,1,56,2910,2854
10231,1,0,5,0,-5
10232,0,0,71,0,-71
10233,1,1,632,1385,753
10234,1,1,539,1816,1277
10235,1,0,5,0,-5
10236,0,0,1,0,-1
10237,1,1,61,1773,1712
10238,1,1,296,1267,971
10239,0,0,6,0,-6
10240,1,1,1390,1265,-125
10241,1,0,27,0,-27
10242,1,0,2,0,-2
10243,1,0,1,0,-1
10244,1,1,198,1561,1363
10245,1,0,2,0,-2
10246,1,0,29,0,-29
10247,1,1,44,1718,1674
10248,1,0,40,0,-40
10249,1,0,351,0,-351
10250,0,0,59,0,-59
10251,1,1,73,1412,1339
10252,1,0,2,0,-2
10253,0,0,15,0,-15
10254,0,0,134,0,-134
10255,1,0,93,0,-93
10256,0,0,71,0,-71
10257,1,1,103,1325,1222
10258,1,1,429,2022,1593
10259,0,0,180,0,-180
10260,1,0,117,0,-117
10261,0,0,22,0,-22
10262,0,0,48,0,-48
10263,1,1,909,1413,504
10264,0,0,45,0,-45
10265,1,0,36,0,-36
10266,1,0,6,0,-6
10267,0,0,15,0,-15
10268,1,1,355,2097,1742
10269,0,0,2,0,-2
10270,1,1,419,1976,1557
10271,1,0,23,0,-23
10272,1,0,13,0,-13
10273,1,0,139,0,-139
10274,1,0,32,0,-32
10275,1,1,343,1326,983
10276,0,0,49,0,-49
10277,1,0,22,0,-22
10278,1,1,168,1481,1313
10279,1,1,304,1427,1123
10280,0,0,38,0,-38
10281,1,1,184,1949,1765
10282,1,0,38,0,-38
10283,0,0,50,0,-50
10284,1,1,846,1430,584
10285,1,0,8,0,-8
10286,0,0,50,0,-50
10287,1,0,97,0,-97
10288,1,1,157,1410,1253
10289,0,0,63,0,-63
10290,0,0,3,0,-3
10291,0,0,61,0,-61
10292,1,1,1411,1289,-122
10293,0,0,15,0,-15
10294,1,1,1475,1251,-224
10295,0,0,125,0,-125
10296,0,0,123,0,-123
10297,1,0,67,0,-67
10298,1,0,54,0,-54
10299,0,0,2,0,-2
10300,1,0,63,0,-63
10301,0,0,230,0,-230
10302,1,1,838,1219,381
10303,1,0,2,0,-2
10304,0,0,6,0,-6
10305,0,0,20,0,-20
10306,0,0,64,0,-64
10307,1,1,1057,1371,314
10308,0,0,160,0,-160
10309,1,0,30,0,-30
10310,0,0,13,0,-13
10311,1,1,444,1797,1353
10312,0,0,9,0,-9
10313,1,1,168,1597,1429
10314,0,0,111,0,-111
10315,0,0,61,0,-61
10316,1,1,1014,1307,293
10317,1,0,158,0,-158
10318,1,1,607,1280,673
10319,1,1,1710,1248,-462
10320,0,0,41,0,-41
10321,1,0,2,0,-2
10322,1,1,160,1218,1058
10323,0,0,63,0,-63
10324,1,1,300,1832,1532
10325,1,0,4,0,-4
10326,1,0,33,0,-33
10327,1,1,1307,4538,3231
10328,0,0,15,0,-15
10329,1,0,120,0,-120
10330,1,1,253,1447,1194
10331,0,0,119,0,-119
10332,0,0,16,0,-16
10333,1,0,129,0,-129
10334,1,0,7,0,-7
10335,0,0,7,0,-7
10336,1,0,13,0,-13
10337,0,0,59,0,-59
10338,0,0,57,0,-57
10339,1,1,79,1261,1182
10340,0,0,98,0,-98
10341,0,0,133,0,-133
10342,0,0,13,0,-13
10343,1,0,164,0,-164
10344,0,0,79,0,-79
10345,0,0,28,0,-28
10346,1,1,2914,1246,-1668
10347,1,0,20,0,-20
10348,1,0,25,0,-25
10349,1,0,0,0,0
10350,0,0,46,0,-46
10351,1,0,58,0,-58
10352,0,0,10,0,-10
10353,1,1,1909,1398,-511
10354,0,0,5,0,-5
10355,0,0,10,0,-10
10356,0,0,140,0,-140
10357,0,0,6,0,-6
10358,0,0,11,0,-11
10359,1,0,7,0,-7
10360,1,1,545,1406,861
10361,0,0,1,0,-1
10362,1,0,45,0,-45
10363,0,0,227,0,-227
10364,0,0,159,0,-159
10365,1,0,88,0,-88
10366,0,0,65,0,-65
10367,1,1,220,1381,1161
10368,1,1,369,1331,962
10369,0,0,31,0,-31
10370,1,1,340,1439,1099
10371,1,0,60,0,-60
10372,1,0,19,0,-19
10373,0,0,3,0,-3
10374,0,0,47,0,-47
10375,1,0,47,0,-47
10376,0,0,1,0,-1
10377,0,0,12,0,-12
10378,0,0,19,0,-19
10379,1,1,34,1975,1941
10380,0,0,13,0,-13
10381,0,0,3,0,-3
10382,1,0,57,0,-57
10383,1,1,321,1632,1311
10384,0,0,67,0,-67
10385,0,0,10,0,-10
10386,1,0,20,0,-20
10387,1,0,121,0,-121
10388,0,0,34,0,-34
10389,1,0,34,0,-34
10390,0,0,74,0,-74
10391,1,1,187,1240,1053
10392,0,0,51,0,-51
10393,0,0,50,0,-50
10394,0,0,62,0,-62
10395,0,0,71,0,-71
10396,1,0,65,0,-65
10397,1,1,239,1287,1048
10398,1,1,81,1315,1234
10399,0,0,18,0,-18
10400,0,0,56,0,-56
10401,1,0,40,0,-40
10402,0,0,57,0,-57
10403,0,0,58,0,-58
10404,1,1,582,1320,738
10405,1,0,63,0,-63
10406,0,0,13,0,-13
10407,1,1,549,4529,3980
10408,1,1,312,2533,2221
10409,0,0,3,0,-3
10410,1,1,557,1826,1269
10411,1,0,42,0,-42
10412,1,0,33,0,-33
10413,1,1,448,1510,1062
10414,1,1,288,1436,1148
10415,1,1,1143,1443,300
10416,0,0,171,0,-171
10417,0,0,68,0,-68
10418,0,0,26,0,-26
10419,1,0,50,0,-50
10420,0,0,17,0,-17
10421,1,1,627,5866,5239
10422,1,1,601,1327,726
10423,1,0,168,0,-168
10424,1,0,33,0,-33
10425,1,0,81,0,-81
10426,0,0,16,0,-16
10427,0,0,18,0,-18
10428,1,1,73,1462,1389
10429,1,1,205,1328,1123
10430,1,0,33,0,-33
10431,1,1,857,2669,1812
10432,1,0,57,0,-57
10433,1,0,33,0,-33
10434,1,0,22,0,-22
10435,0,0,8,0,-8
10436,0,0,30,0,-30
10437,0,0,60,0,-60
10438,0,0,10,0,-10
10439,1,1,222,1738,1516
10440,0,0,3,0,-3
10441,0,0,82,0,-82
10442,1,0,36,0,-36
10443,1,0,26,0,-26
10444,1,1,1209,1748,539
10445,0,0,7,0,-7
10446,0,0,31,0,-31
10447,0,0,111,0,-111
10448,0,0,54,0,-54
10449,0,0,13,0,-13
10450,1,0,108,0,-108
10451,1,1,864,1725,861
10452,0,0,195,0,-195
10453,0,0,19,0,-19
10454,1,0,81,0,-81
10455,0,0,8,0,-8
10456,1,1,89,1550,1461
10457,0,0,2,0,-2
10458,1,1,616,1941,1325
10459,1,0,22,0,-22
10460,1,1,396,2484,2088
10461,0,0,13,0,-13
10462,1,1,40,1218,1178
10463,1,1,722,1485,763
10464,1,0,78,0,-78
10465,1,1,795,1245,450
10466,0,0,2,0,-2
10467,1,0,144,0,-144
10468,0,0,87,0,-87
10469,1,1,1222,1224,2
10470,1,1,63,1479,1416
10471,0,0,2,0,-2
10472,1,1,1228,1268,40
10473,1,0,51,0,-51
10474,1,1,97,1702,1605
10475,1,0,17,0,-17
10476,0,0,205,0,-205
10477,1,1,1321,1329,8
10478,0,0,56,0,-56
10479,1,1,1268,1716,448
10480,0,0,5,0,-5
10481,0,0,0,0,0
10482,0,0,47,0,-47
10483,0,0,64,0,-64
10484,1,1,1416,1480,64
10485,0,0,5,0,-5
10486,0,0,30,0,-30
10487,0,0,56,0,-56
10488,1,1,1290,1426,136
10489,0,0,11,0,-11
10490,1,1,124,1328,1204
10491,1,0,80,0,-80
10492,1,1,142,4918,4776
10493,1,0,20,0,-20
10494,0,0,69,0,-69
10495,1,0,70,0,-70
10496,1,1,1911,1263,-648
10497,1,1,741,1270,529
10498,0,0,45,0,-45
10499,1,1,989,1523,534
10500,0,0,74,0,-74
10501,1,0,4,0,-4
10502,0,0,59,0,-59
10503,0,0,78,0,-78
10504,0,0,0,0,0
10505,0,0,27,0,-27
10506,0,0,3,0,-3
10507,1,1,333,2210,1877
10508,1,1,168,1207,1039
10509,1,0,19,0,-19
10510,0,0,119,0,-119
10511,1,1,717,1691,974
10512,0,0,24,0,-24
10513,0,0,24,0,-24
10514,1,1,130,2466,2336
10515,1,1,1308,1325,17
10516,1,1,914,1307,393
10517,0,0,55,0,-55
10518,0,0,51,0,-51
10519,0,0,53,0,-53
10520,1,0,3,0,-3
10521,1,1,255,1385,1130
10522,0,0,39,0,-39
10523,1,0,22,0,-22
10524,0,0,7,0,-7
10525,1,1,415,1334,919
10526,1,1,442,1350,908
10527,1,1,84,1219,1135
10528,0,0,13,0,-13
10529,0,0,135,0,-135
10530,1,1,953,1250,297
10531,0,0,174,0,-174
10532,0,0,83,0,-83
10533,1,0,1,0,-1
10534,0,0,137,0,-137
10535,0,0,40,0,-40
10536,1,0,32,0,-32
10537,0,0,32,0,-32
10538,0,0,62,0,-62
10539,0,0,18,0,-18
10540,0,0,5,0,-5
10541,1,0,11,0,-11
10542,1,0,18,0,-18
10543,0,0,58,0,-58
10544,1,1,605,2385,1780
10545,1,1,696,1529,833
10546,0,0,17,0,-17
10547,1,1,58,1331,1273
10548,0,0,21,0,-21
10549,0,0,0,0,0
10550,1,1,313,1244,931
10551,0,0,43,0,-43
10552,0,0,17,0,-17
10553,1,1,367,1332,965
10554,0,0,37,0,-37
10555,1,0,38,0,-38
10556,0,0,14,0,-14
10557,1,1,578,1348,770
10558,1,0,3,0,-3
10559,1,1,1073,1437,364
10560,1,1,736,2326,1590
10561,0,0,40,0,-40
10562,0,0,30,0,-30
10563,1,1,303,1234,931
10564,1,0,26,0,-26
10565,0,0,3,0,-3
10566,1,0,19,0,-19
10567,1,1,579,1400,821
10568,0,0,48,0,-48
10569,0,0,90,0,-90
10570,0,0,72,0,-72
10571,1,0,24,0,-24
10572,1,1,317,1245,928
10573,0,0,8,0,-8
10574,1,0,37,0,-37
10575,1,1,581,1803,1222
10576,1,0,196,0,-196
10577,1,1,611,1335,724
10578,0,0,3,0,-3
10579,1,0,18,0,-18
10580,1,0,47,0,-47
10581,0,0,58,0,-58
10582,1,1,1276,1317,41
10583,1,1,403,2325,1922
10584,0,0,34,0,-34
10585,1,1,453,2878,2425
10586,1,1,427,1372,945
10587,0,0,206,0,-206
10588,1,1,1257,1506,249
10589,1,0,82,0,-82
10590,0,0,31,0,-31
10591,1,0,23,0,-23
10592,0,0,4,0,-4
10593,0,0,114,0,-114
10594,0,0,28,0,-28
10595,1,0,68,0,-68
10596,1,0,15,0,-15
10597,0,0,12,0,-12
10598,0,0,29,0,-29
10599,1,0,36,0,-36
10600,1,0,51,0,-51
10601,0,0,0,0,0
10602,1,0,4,0,-4
10603,0,0,45,0,-45
10604,0,0,12,0,-12
10605,0,0,122,0,-122
10606,0,0,8,0,-8
10607,1,0,39,0,-39
10608,1,0,36,0,-36
10609,0,0,15,0,-15
10610,1,0,23,0,-23
10611,1,1,202,1593,1391
10612,1,1,583,1388,805
10613,0,0,123,0,-123
10614,1,1,693,1293,600
10615,1,1,545,1208,663
10616,0,0,117,0,-117
10617,1,1,1050,1252,202
10618,1,1,392,1557,1165
10619,0,0,14,0,-14
10620,0,0,78,0,-78
10621,0,0,14,0,-14
10622,0,0,83,0,-83
10623,1,1,234,2343,2109
10624,1,1,959,1232,273
10625,1,1,331,1262,931
10626,1,1,155,1200,1045
10627,0,0,145,0,-145
10628,1,1,323,1252,929
10629,1,0,22,0,-22
10630,1,1,265,1611,1346
10631,1,0,0,0,0
10632,1,0,140,0,-140
10633,1,1,1271,2038,767
10634,1,0,26,0,-26
10635,1,0,19,0,-19
10636,0,0,18,0,-18
10637,1,0,137,0,-137
10638,1,1,40,2047,2007
10639,0,0,42,0,-42
10640,1,1,1708,1549,-159
10641,0,0,33,0,-33
10642,0,0,26,0,-26
10643,0,0,71,0,-71
10644,1,0,92,0,-92
10645,0,0,17,0,-17
10646,0,0,17,0,-17
10647,1,0,225,0,-225
10648,1,0,29,0,-29
10649,1,0,1,0,-1
10650,1,0,2,0,-2
10651,0,0,216,0,-216
10652,1,1,2153,1274,-879
10653,0,0,1,0,-1
10654,1,1,1413,1319,-94
10655,1,1,367,1213,846
10656,0,0,24,0,-24
10657,1,0,58,0,-58
10658,0,0,10,0,-10
10659,1,0,29,0,-29
10660,0,0,87,0,-87
10661,1,0,14,0,-14
10662,1,1,663,1609,946
10663,0,0,37,0,-37
10664,1,0,3,0,-3
10665,1,0,46,0,-46
10666,0,0,40,0,-40
10667,0,0,61,0,-61
10668,1,0,18,0,-18
10669,1,0,141,0,-141
10670,0,0,9,0,-9
10671,1,0,2,0,-2
10672,1,1,948,1297,349
10673,0,0,14,0,-14
10674,1,0,63,0,-63
10675,1,1,209,2322,2113
10676,0,0,69,0,-69
10677,1,0,8,0,-8
10678,1,0,111,0,-111
10679,1,1,640,1663,1023
10680,1,1,684,1503,819
10681,1,0,16,0,-16
10682,1,1,439,1411,972
10683,0,0,22,0,-22
10684,1,1,373,1227,854
10685,1,1,823,1350,527
10686,0,0,8,0,-8
10687,0,0,44,0,-44
10688,0,0,150,0,-150
10689,0,0,59,0,-59
10690,1,1,85,2643,2558
10691,1,0,5,0,-5
10692,0,0,84,0,-84
10693,1,1,294,1704,1410
10694,1,1,97,1459,1362
10695,0,0,43,0,-43
10696,0,0,67,0,-67
10697,1,0,31,0,-31
10698,1,0,50,0,-50
10699,1,0,16,0,-16
10700,0,0,8,0,-8
10701,1,1,220,1835,1615
10702,1,0,125,0,-125
10703,0,0,42,0,-42
10704,1,1,541,1656,1115
10705,0,0,43,0,-43
10706,1,1,714,1886,1172
10707,0,0,38,0,-38
10708,0,0,4,0,-4
10709,1,0,91,0,-91
10710,0,0,171,0,-171
10711,0,0,0,0,0
10712,1,1,336,1391,1055
10713,1,1,400,1474,1074
10714,0,0,5,0,-5
10715,0,0,19,0,-19
10716,0,0,6,0,-6
10717,1,0,45,0,-45
10718,0,0,16,0,-16
10719,1,1,234,1326,1092
10720,1,0,20,0,-20
10721,0,0,30,0,-30
10722,1,1,1765,1220,-545
10723,1,1,546,1690,1144
10724,1,1,320,1318,998
10725,1,1,203,1457,1254
10726,0,0,58,0,-58
10727,0,0,69,0,-69
10728,0,0,46,0,-46
10729,0,0,62,0,-62
10730,0,0,101,0,-101
10731,1,1,914,1405,491
10732,1,1,950,1643,693
10733,0,0,101,0,-101
10734,1,0,72,0,-72
10735,1,0,38,0,-38
10736,0,0,30,0,-30
10737,1,1,1293,1286,-7
10738,1,0,48,0,-48
10739,0,0,46,0,-46
10740,0,0,96,0,-96
10741,1,0,4,0,-4
10742,0,0,137,0,-137
10743,1,1,1380,1206,-174
10744,1,1,462,1289,827
10745,1,0,11,0,-11
10746,0,0,54,0,-54
10747,0,0,10,0,-10
10748,1,1,1214,1545,331
10749,0,0,4,0,-4
10750,0,0,18,0,-18
10751,1,0,7,0,-7
10752,1,1,1001,1280,279
10753,1,1,1139,1623,484
10754,1,1,1003,1260,257
10755,0,0,4,0,-4
10756,1,0,77,0,-77
10757,1,0,139,0,-139
10758,0,0,84,0,-84
10759,1,1,184,1773,1589
10760,0,0,22,0,-22
10761,1,1,131,1369,1238
10762,0,0,12,0,-12
10763,1,1,814,1513,699
10764,1,0,236,0,-236
10765,1,1,357,1362,1005
10766,0,0,41,0,-41
10767,1,1,955,1228,273
10768,1,1,454,1204,750
10769,1,0,11,0,-11
10770,0,0,16,0,-16
10771,0,0,12,0,-12
10772,1,0,109,0,-109
10773,1,1,21,1211,1190
10774,0,0,183,0,-183
10775,0,0,30,0,-30
10776,1,1,67,1864,1797
10777,1,0,36,0,-36
10778,0,0,12,0,-12
10779,1,0,7,0,-7
10780,1,1,593,1517,924
10781,0,0,59,0,-59
10782,0,0,4,0,-4
10783,1,1,168,1500,1332
10784,1,0,24,0,-24
10785,0,0,91,0,-91
10786,0,0,90,0,-90
10787,1,0,4,0,-4
10788,0,0,17,0,-17
10789,0,0,12,0,-12
10790,1,0,3,0,-3
10791,0,0,17,0,-17
10792,1,0,0,0,0
10793,0,0,11,0,-11
10794,1,1,94,1287,1193
10795,0,0,119,0,-119
10796,1,1,549,1307,758
10797,0,0,157,0,-157
10798,0,0,7,0,-7
10799,1,1,14,1306,1292
10800,1,0,29,0,-29
10801,0,0,4,0,-4
10802,0,0,89,0,-89
10803,0,0,34,0,-34
10804,1,1,1755,1252,-503
10805,0,0,0,0,0
10806,1,0,15,0,-15
10807,1,0,4,0,-4
10808,1,0,35,0,-35
10809,1,0,118,0,-118
10810,0,0,294,0,-294
10811,1,1,73,1379,1306
10812,0,0,221,0,-221
10813,1,1,254,1217,963
10814,1,1,1154,1224,70
10815,1,1,367,3054,2687
10816,1,0,71,0,-71
10817,1,1,605,1589,984
10818,0,0,75,0,-75
10819,1,0,4,0,-4
10820,1,1,1261,1739,478
10821,0,0,9,0,-9
10822,1,0,19,0,-19
10823,1,0,41,0,-41
10824,1,0,15,0,-15
10825,1,1,120,2359,2239
10826,1,1,76,1376,1300
10827,0,0,90,0,-90
10828,1,0,17,0,-17
10829,1,0,54,0,-54
10830,0,0,12,0,-12
10831,1,1,69,1613,1544
10832,0,0,104,0,-104
10833,0,0,28,0,-28
10834,0,0,116,0,-116
10835,0,0,17,0,-17
10836,1,1,12,1285,1273
10837,1,1,516,1357,841
10838,0,0,10,0,-10
10839,1,0,108,0,-108
10840,1,0,14,0,-14
10841,0,0,76,0,-76
10842,0,0,10,0,-10
10843,0,0,145,0,-145
10844,1,0,66,0,-66
10845,0,0,60,0,-60
10846,1,1,907,1290,383
10847,1,1,275,1341,1066
10848,1,0,19,0,-19
10849,1,0,2,0,-2
10850,1,0,38,0,-38
10851,1,1,253,1220,967
10852,1,1,1549,1279,-270
10853,1,0,20,0,-20
10854,1,0,35,0,-35
10855,0,0,2,0,-2
10856,1,1,78,1229,1151
10857,0,0,140,0,-140
10858,1,1,157,1200,1043
10859,1,0,26,0,-26
10860,0,0,24,0,-24
10861,1,1,866,2014,1148
10862,0,0,72,0,-72
10863,0,0,4,0,-4
10864,1,1,94,1863,1769
10865,0,0,55,0,-55
10866,1,1,220,1425,1205
10867,0,0,18,0,-18
10868,0,0,30,0,-30
10869,0,0,65,0,-65
10870,1,1,204,1235,1031
10871,0,0,3,0,-3
10872,1,1,67,1424,1357
10873,1,1,247,1367,1120
10874,1,0,90,0,-90
10875,1,0,16,0,-16
10876,1,0,9,0,-9
10877,1,1,973,1731,758
10878,1,0,9,0,-9
10879,0,0,197,0,-197
10880,1,1,893,2413,1520
10881,0,0,47,0,-47
10882,1,0,52,0,-52
10883,1,0,4,0,-4
10884,1,1,116,1815,1699
10885,1,0,2,0,-2
10886,1,0,27,0,-27
10887,0,0,1,0,-1
10888,0,0,18,0,-18
10889,0,0,0,0,0
10890,0,0,28,0,-28
10891,0,0,18,0,-18
10892,1,1,875,1335,460
10893,1,0,22,0,-22
10894,0,0,70,0,-70
10895,1,1,234,1450,1216
10896,1,1,315,4115,3800
10897,1,0,82,0,-82
10898,0,0,38,0,-38
10899,0,0,22,0,-22
10900,0,0,39,0,-39
10901,1,1,771,1974,1203
10902,1,0,26,0,-26
10903,1,0,53,0,-53
10904,0,0,85,0,-85
10905,1,0,5,0,-5
10906,0,0,73,0,-73
10907,0,0,18,0,-18
10908,0,0,2,0,-2
10909,0,0,14,0,-14
10910,1,1,2410,2904,494
10911,0,0,100,0,-100
10912,1,1,103,5997,5894
10913,1,1,1131,1273,142
10914,1,0,18,0,-18
10915,1,0,14,0,-14
10916,0,0,53,0,-53
10917,0,0,3,0,-3
10918,1,0,3,0,-3
10919,1,0,56,0,-56
10920,1,0,12,0,-12
10921,1,0,229,0,-229
10922,0,0,39,0,-39
10923,1,1,18,1252,1234
10924,0,0,11,0,-11
10925,1,0,51,0,-51
10926,0,0,112,0,-112
10927,0,0,43,0,-43
10928,1,0,66,0,-66
10929,0,0,62,0,-62
10930,0,0,0,0,0
10931,0,0,118,0,-118
10932,0,0,25,0,-25
10933,0,0,9,0,-9
10934,0,0,2,0,-2
10935,1,1,249,1353,1104
10936,1,0,16,0,-16
10937,0,0,36,0,-36
10938,0,0,18,0,-18
10939,1,1,160,1347,1187
10940,0,0,2,0,-2
10941,1,0,1,0,-1
10942,0,0,41,0,-41
10943,1,1,196,1223,1027
10944,0,0,92,0,-92
10945,0,0,29,0,-29
10946,1,0,68,0,-68
10947,1,1,749,1565,816
10948,1,1,970,2651,1681
10949,0,0,61,0,-61
10950,0,0,15,0,-15
10951,0,0,30,0,-30
10952,1,1,422,1325,903
10953,1,0,64,0,-64
10954,1,1,569,1434,865
10955,1,0,1,0,-1
10956,0,0,28,0,-28
10957,1,0,98,0,-98
10958,1,0,34,0,-34
10959,1,0,59,0,-59
10960,0,0,65,0,-65
10961,1,0,9,0,-9
10962,1,1,60,2009,1949
10963,1,0,63,0,-63
10964,0,0,12,0,-12
10965,0,0,111,0,-111
10966,0,0,29,0,-29
10967,1,1,211,1217,1006
10968,0,0,44,0,-44
10969,0,0,17,0,-17
10970,1,1,940,1807,867
10971,0,0,177,0,-177
10972,1,1,155,1239,1084
10973,1,1,699,1244,545
10974,1,1,606,1427,821
10975,0,0,27,0,-27
10976,0,0,2,0,-2
10977,1,0,0,0,0
10978,0,0,86,0,-86
10979,1,0,29,0,-29
10980,0,0,51,0,-51
10981,1,1,748,1332,584
10982,0,0,55,0,-55
10983,0,0,82,0,-82
10984,1,0,30,0,-30
10985,0,0,26,0,-26
10986,1,0,116,0,-116
10987,1,1,812,1280,468
10988,1,1,139,1489,1350
10989,1,0,59,0,-59
10990,1,1,1153,2258,1105
10991,1,1,43,1692,1649
10992,0,0,30,0,-30
10993,1,1,369,1774,1405
10994,0,0,68,0,-68
10995,1,0,27,0,-27
10996,0,0,59,0,-59
10997,1,0,116,0,-116
10998,0,0,85,0,-85
10999,1,1,1031,1974,943
11000,0,0,41,0,-41
11001,0,0,40,0,-40
11002,0,0,14,0,-14
11003,1,0,101,0,-101
11004,0,0,0,0,0
11005,0,0,36,0,-36
11006,0,0,27,0,-27
11007,1,1,345,2253,1908
11008,0,0,15,0,-15
11009,1,1,371,1299,928
11010,1,1,1653,1854,201
11011,1,1,40,1526,1486
11012,0,0,136,0,-136
11013,1,1,135,1276,1141
11014,1,1,1121,1235,114
11015,0,0,49,0,-49
11016,1,1,497,1225,728
11017,1,0,97,0,-97
11018,1,1,620,1333,713
11019,1,1,952,1288,336
11020,0,0,162,0,-162
11021,1,1,143,2032,1889
11022,0,0,9,0,-9
11023,0,0,141,0,-141
11024,1,1,8,1418,1410
11025,0,0,4,0,-4
11026,0,0,2,0,-2
11027,0,0,145,0,-145
11028,0,0,13,0,-13
11029,0,0,9,0,-9
11030,1,1,264,1325,1061
11031,1,0,44,0,-44
11032,0,0,66,0,-66
11033,1,0,21,0,-21
11034,1,0,102,0,-102
11035,1,1,360,1274,914
11036,1,1,578,1992,1414
11037,1,0,12,0,-12
11038,1,1,831,1753,922
11039,1,1,323,1265,942
11040,1,0,33,0,-33
11041,1,0,24,0,-24
11042,1,0,103,0,-103
11043,1,1,62,1243,1181
11044,1,1,209,1727,1518
11045,1,1,633,1214,581
11046,1,0,15,0,-15
11047,1,1,743,1454,711
11048,1,1,342,1256,914
11049,1,1,197,2119,1922
11050,0,0,2,0,-2
11051,0,0,60,0,-60
11052,1,1,27,1202,1175
11053,0,0,40,0,-40
11054,1,0,46,0,-46
11055,0,0,24,0,-24
11056,1,0,47,0,-47
11057,1,0,182,0,-182
11058,1,0,42,0,-42
11059,0,0,51,0,-51
11060,1,0,5,0,-5
11061,0,0,4,0,-4
11062,1,0,44,0,-44
11063,0,0,39,0,-39
11064,0,0,6,0,-6
11065,1,1,276,4761,4485
11066,1,0,46,0,-46
11067,0,0,22,0,-22
11068,0,0,49,0,-49
11069,1,1,320,1644,1324
11070,1,0,137,0,-137
11071,1,0,28,0,-28
11072,1,1,188,2134,1946
11073,1,1,1061,1517,456
11074,1,1,348,1656,1308
11075,0,0,158,0,-158
11076,1,1,1352,1515,163
11077,1,0,7,0,-7
11078,0,0,46,0,-46
11079,0,0,71,0,-71
11080,0,0,9,0,-9
11081,1,0,31,0,-31
11082,1,0,11,0,-11
11083,1,1,895,1347,452
11084,0,0,237,0,-237
11085,1,0,76,0,-76
11086,0,0,137,0,-137
11087,0,0,47,0,-47
11088,1,0,18,0,-18
11089,1,0,5,0,-5
11090,0,0,33,0,-33
11091,1,0,115,0,-115
11092,0,0,5,0,-5
11093,0,0,11,0,-11
11094,1,0,70,0,-70
11095,1,0,90,0,-90
11096,1,0,60,0,-60
11097,1,1,353,1217,864
11098,0,0,39,0,-39
11099,1,0,47,0,-47
11100,0,0,2,0,-2
11101,1,0,11,0,-11
11102,1,1,698,2450,1752
11103,0,0,67,0,-67
11104,0,0,160,0,-160
11105,0,0,29,0,-29
11106,0,0,203,0,-203
11107,0,0,60,0,-60
11108,1,0,18,0,-18
11109,1,1,690,1589,899
11110,1,0,14,0,-14
11111,0,0,81,0,-81
11112,0,0,37,0,-37
11113,1,0,47,0,-47
11114,1,0,16,0,-16
11115,1,0,84,0,-84
11116,1,0,45,0,-45
11117,0,0,9,0,-9
11118,1,1,233,1232,999
11119,1,1,678,1854,1176
11120,0,0,20,0,-20
11121,1,0,66,0,-66
11122,1,0,33,0,-33
11123,1,1,58,1573,1515
11124,0,0,142,0,-142
11125,0,0,29,0,-29
11126,0,0,46,0,-46
11127,1,1,735,1337,602
11128,0,0,81,0,-81
11129,0,0,17,0,-17
11130,1,0,58,0,-58
11131,0,0,39,0,-39
11132,1,0,33,0,-33
11133,0,0,58,0,-58
11134,1,0,34,0,-34
11135,1,1,634,1753,1119
11136,1,0,24,0,-24
11137,1,0,42,0,-42
11138,0,0,1,0,-1
11139,1,1,148,1359,1211
11140,0,0,58,0,-58
11141,0,0,55,0,-55
11142,1,0,3,0,-3
11143,1,0,135,0,-135
11144,0,0,10,0,-10
11145,0,0,58,0,-58
11146,1,1,776,1944,1168
11147,0,0,23,0,-23
11148,1,0,19,0,-19
11149,1,1,385,1622,1237
11150,1,0,35,0,-35
11151,0,0,48,0,-48
11152,1,1,646,1891,1245
11153,1,0,27,0,-27
11154,1,0,28,0,-28
11155,1,1,178,1202,1024
11156,1,0,50,0,-50
11157,1,0,33,0,-33
11158,0,0,34,0,-34
11159,1,1,213,1781,1568
11160,1,1,336,1609,1273
11161,0,0,16,0,-16
11162,1,0,10,0,-10
11163,1,0,30,0,-30
11164,1,1,66,1986,1920
11165,1,0,128,0,-128
11166,1,1,143,1735,1592
11167,1,1,1041,1740,699
11168,1,1,396,1516,1120
11169,1,0,17,0,-17
11170,1,0,32,0,-32
11171,0,0,35,0,-35
11172,1,1,165,1263,1098
11173,0,0,5,0,-5
11174,0,0,42,0,-42
11175,1,0,57,0,-57
11176,0,0,15,0,-15
11177,1,0,0,0,0
11178,1,1,291,1318,1027
11179,1,1,668,1295,627
11180,0,0,45,0,-45
11181,1,0,14,0,-14
11182,1,0,0,0,0
11183,0,0,18,0,-18
11184,0,0,247,0,-247
11185,0,0,43,0,-43
11186,1,0,149,0,-149
11187,0,0,92,0,-92
11188,0,0,24,0,-24
11189,0,0,22,0,-22
11190,1,0,38,0,-38
11191,1,1,79,1618,1539
11192,1,1,99,1478,1379
11193,0,0,6,0,-6
11194,1,0,60,0,-60
11195,0,0,13,0,-13
11196,0,0,64,0,-64
11197,1,0,15,0,-15
11198,0,0,60,0,-60
11199,1,1,70,1406,1336
11200,0,0,80,0,-80
11201,0,0,37,0,-37
11202,0,0,24,0,-24
11203,0,0,67,0,-67
11204,0,0,58,0,-58
11205,0,0,212,0,-212
11206,1,0,36,0,-36
11207,0,0,23,0,-23
11208,0,0,61,0,-61
11209,1,0,83,0,-83
11210,1,1,473,1242,769
11211,0,0,25,0,-25
11212,0,0,146,0,-146
11213,0,0,36,0,-36
11214,0,0,78,0,-78
11215,1,1,122,1510,1388
11216,0,0,27,0,-27
11217,0,0,47,0,-47
11218,1,1,1009,2202,1193
11219,1,0,42,0,-42
11220,0,0,47,0,-47
11221,1,0,45,0,-45
11222,1,0,31,0,-31
11223,1,0,26,0,-26
11224,0,0,4,0,-4
11225,0,0,95,0,-95
11226,0,0,34,0,-34
11227,0,0,8,0,-8
11228,1,0,7,0,-7
11229,1,0,17,0,-17
11230,0,0,27,0,-27
11231,0,0,24,0,-24
11232,1,0,82,0,-82
11233,0,0,96,0,-96
11234,0,0,11,0,-11
11235,0,0,20,0,-20
11236,0,0,37,0,-37
11237,1,1,80,1720,1640
11238,1,0,58,0,-58
11239,0,0,114,0,-114
11240,0,0,37,0,-37
11241,1,1,952,1646,694
11242,0,0,85,0,-85
11243,0,0,26,0,-26
11244,1,1,538,1367,829
11245,0,0,41,0,-41
11246,1,0,73,0,-73
11247,0,0,0,0,0
11248,1,1,748,1330,582
11249,0,0,6,0,-6
11250,1,0,0,0,0
11251,1,1,372,1313,941
11252,1,1,1158,1223,65
11253,1,0,60,0,-60
11254,1,0,71,0,-71
11255,0,0,17,0,-17
11256,1,0,41,0,-41
11257,1,0,36,0,-36
11258,1,0,51,0,-51
11259,0,0,120,0,-120
11260,1,1,488,1881,1393
11261,0,0,85,0,-85
11262,1,0,39,0,-39
11263,1,0,15,0,-15
11264,1,1,907,1315,408
11265,0,0,31,0,-31
11266,1,1,2740,2103,-637
11267,1,1,139,1419,1280
11268,1,1,1306,1502,196
11269,1,1,361,1373,1012
11270,1,0,2,0,-2
11271,1,1,275,2937,2662
11272,0,0,72,0,-72
11273,1,0,7,0,-7
11274,1,0,9,0,-9
11275,0,0,72,0,-72
11276,0,0,0,0,0
11277,0,0,13,0,-13
11278,1,0,4,0,-4
11279,1,1,901,2318,1417
11280,1,0,0,0,0
11281,0,0,102,0,-102
11282,1,0,31,0,-31
11283,1,0,93,0,-93
11284,1,1,150,1327,1177
11285,0,0,48,0,-48
11286,1,1,541,1803,1262
11287,0,0,98,0,-98
11288,0,0,169,0,-169
11289,1,0,89,0,-89
11290,0,0,12,0,-12
11291,1,1,665,1807,1142
11292,1,0,10,0,-10
11293,1,0,248,0,-248
11294,1,1,118,1362,1244
11295,1,1,735,1543,808
11296,1,1,253,1883,1630
11297,1,0,3,0,-3
11298,1,1,218,1623,1405
11299,0,0,35,0,-35
11300,0,0,171,0,-171
11301,0,0,63,0,-63
11302,1,0,24,0,-24
11303,1,1,541,1388,847
11304,1,0,22,0,-22
11305,1,1,208,1493,1285
11306,0,0,48,0,-48
11307,1,1,371,2169,1798
11308,0,0,23,0,-23
11309,1,1,299,1536,1237
11310,0,0,43,0,-43
11311,0,0,19,0,-19
11312,1,1,85,1565,1480
11313,1,1,62,1268,1206
11314,0,0,42,0,-42
11315,1,0,24,0,-24
11316,1,1,1047,1712,665
11317,0,0,39,0,-39
11318,1,1,493,1906,1413
11319,1,1,128,1369,1241
11320,1,1,779,1244,465
11321,1,0,119,0,-119
11322,1,0,10,0,-10
11323,0,0,53,0,-53
11324,1,1,320,1477,1157
11325,1,0,10,0,-10
11326,1,0,59,0,-59
11327,0,0,46,0,-46
11328,1,1,81,1267,1186
11329,1,1,149,1251,1102
11330,0,0,83,0,-83
11331,1,1,1642,1204,-438
11332,1,0,13,0,-13
11333,0,0,66,0,-66
11334,1,1,1340,1389,49
11335,0,0,165,0,-165
11336,0,0,72,0,-72
11337,0,0,133,0,-133
11338,1,1,65,1218,1153
11339,1,1,166,1357,1191
11340,1,1,51,1203,1152
11341,1,1,283,1412,1129
11342,0,0,90,0,-90
11343,1,1,215,3002,2787
11344,0,0,2,0,-2
11345,0,0,50,0,-50
11346,1,1,117,1289,1172
11347,1,0,10,0,-10
11348,0,0,44,0,-44
11349,1,0,118,0,-118
11350,1,1,447,1407,960
11351,1,1,72,1293,1221
11352,0,0,6,0,-6
11353,0,0,49,0,-49
11354,0,0,31,0,-31
11355,1,0,159,0,-159
11356,0,0,8,0,-8
11357,0,0,38,0,-38
11358,1,0,24,0,-24
11359,1,1,513,1656,1143
11360,0,0,16,0,-16
11361,1,0,57,0,-57
11362,1,1,520,1343,823
11363,1,0,2,0,-2
11364,1,0,28,0,-28
11365,0,0,25,0,-25
11366,1,0,3,0,-3
11367,1,0,21,0,-21
11368,0,0,4,0,-4
11369,0,0,183,0,-183
11370,1,1,416,1495,1079
11371,1,1,978,1611,633
11372,1,0,25,0,-25
11373,1,1,542,1917,1375
11374,1,1,310,1388,1078
11375,0,0,50,0,-50
11376,0,0,5,0,-5
11377,1,1,329,1312,983
11378,1,1,618,1610,992
11379,1,0,120,0,-120
11380,1,1,234,1365,1131
11381,0,0,15,0,-15
11382,0,0,64,0,-64
11383,0,0,51,0,-51
11384,1,1,1412,1963,551
11385,1,0,64,0,-64
11386,0,0,57,0,-57
11387,1,0,4,0,-4
11388,0,0,20,0,-20
11389,0,0,62,0,-62
11390,0,0,23,0,-23
11391,1,1,797,2091,1294
11392,1,1,1265,1295,30
11393,1,0,13,0,-13
11394,1,1,428,1851,1423
11395,1,0,116,0,-116
11396,1,1,958,1417,459
11397,0,0,38,0,-38
11398,1,0,16,0,-16
11399,1,0,29,0,-29
11400,1,0,9,0,-9
11401,1,1,303,1759,1456
11402,0,0,72,0,-72
11403,0,0,11,0,-11
11404,1,0,42,0,-42
11405,1,0,9,0,-9
11406,0,0,11,0,-11
11407,1,1,446,1343,897
11408,1,1,157,1506,1349
11409,1,1,443,1274,831
11410,1,1,434,1650,1216
11411,0,0,124,0,-124
11412,1,1,423,1619,1196
11413,1,0,66,0,-66
11414,1,0,36,0,-36
11415,0,0,18,0,-18
11416,1,0,43,0,-43
11417,1,1,181,2377,2196
11418,1,0,50,0,-50
11419,1,0,34,0,-34
11420,0,0,33,0,-33
11421,0,0,111,0,-111
11422,0,0,11,0,-11
11423,1,1,570,1259,689
11424,1,1,69,1700,1631
11425,0,0,16,0,-16
11426,1,0,13,0,-13
11427,0,0,3,0,-3
11428,1,0,40,0,-40
11429,1,1,226,1202,976
11430,1,0,26,0,-26
11431,1,1,28,1237,1209
11432,1,0,70,0,-70
11433,0,0,0,0,0
11434,1,1,244,1361,1117
11435,1,1,370,1315,945
11436,1,0,28,0,-28
11437,1,1,161,1215,1054
11438,1,1,381,1367,986
11439,1,1,124,2168,2044
11440,0,0,20,0,-20
11441,0,0,22,0,-22
11442,1,0,96,0,-96
11443,0,0,1,0,-1
11444,1,1,165,1523,1358
11445,1,0,88,0,-88
11446,1,0,98,0,-98
11447,0,0,41,0,-41
11448,1,1,141,1338,1197
11449,1,0,9,0,-9
11450,1,1,294,1467,1173
11451,1,0,10,0,-10
11452,0,0,21,0,-21
11453,1,1,666,1691,1025
11454,1,1,777,1794,1017
11455,1,1,231,2139,1908
11456,1,1,260,1213,953
11457,1,1,1181,1209,28
11458,1,1,42,1367,1325
11459,0,0,35,0,-35
11460,1,0,16,0,-16
11461,1,0,69,0,-69
11462,0,0,76,0,-76
11463,1,1,105,1210,1105
11464,1,1,359,1707,1348
11465,1,0,32,0,-32
11466,0,0,36,0,-36
11467,1,0,51,0,-51
11468,0,0,18,0,-18
11469,0,0,113,0,-113
11470,0,0,3,0,-3
11471,0,0,31,0,-31
11472,1,0,48,0,-48
11473,1,0,17,0,-17
11474,0,0,88,0,-88
11475,0,0,4,0,-4
11476,1,0,32,0,-32
11477,1,0,240,0,-240
11478,0,0,9,0,-9
11479,1,1,186,1346,1160
11480,1,1,98,1645,1547
11481,1,0,119,0,-119
11482,0,0,17,0,-17
11483,0,0,2,0,-2
11484,1,0,57,0,-57
11485,1,0,9,0,-9
11486,1,1,1405,1910,505
11487,0,0,1,0,-1
11488,0,0,4,0,-4
11489,1,0,17,0,-17
11490,1,0,27,0,-27
11491,0,0,16,0,-16
11492,1,1,180,1850,1670
11493,0,0,17,0,-17
11494,0,0,0,0,0
11495,0,0,18,0,-18
11496,0,0,19,0,-19
11497,0,0,123,0,-123
11498,1,1,383,1409,1026
11499,1,0,19,0,-19
11500,0,0,30,0,-30
11501,1,0,54,0,-54
11502,1,0,29,0,-29
11503,1,1,1465,1466,1
11504,1,1,407,1665,1258
11505,1,0,98,0,-98
11506,1,0,0,0,0
11507,1,1,247,1632,1385
11508,0,0,35,0,-35
11509,1,1,851,1237,386
11510,1,1,211,1464,1253
11511,1,1,486,1809,1323
11512,0,0,14,0,-14
11513,1,1,552,1266,714
11514,1,0,44,0,-44
11515,0,0,105,0,-105
11516,0,0,22,0,-22
11517,1,1,937,1222,285
11518,1,0,11,0,-11
11519,1,1,458,1269,811
11520,1,1,109,1698,1589
11521,0,0,90,0,-90
11522,0,0,52,0,-52
11523,0,0,63,0,-63
11524,1,1,164,1370,1206
11525,1,1,961,3555,2594
11526,1,1,308,1213,905
11527,1,1,328,1285,957
11528,1,0,40,0,-40
11529,1,0,77,0,-77
11530,0,0,107,0,-107
11531,1,1,961,2628,1667
11532,1,0,1,0,-1
11533,1,1,433,1203,770
11534,0,0,43,0,-43
11535,1,0,95,0,-95
11536,1,1,67,1441,1374
11537,1,1,319,1231,912
11538,1,0,20,0,-20
11539,1,0,56,0,-56
11540,0,0,40,0,-40
11541,1,1,483,1440,957
11542,0,0,82,0,-82
11543,1,1,276,1963,1687
11544,1,0,61,0,-61
11545,0,0,85,0,-85
11546,0,0,38,0,-38
11547,1,0,77,0,-77
11548,1,1,328,2101,1773
11549,1,0,63,0,-63
11550,0,0,59,0,-59
11551,1,1,1251,1250,-1
11552,0,0,62,0,-62
11553,0,0,156,0,-156
11554,0,0,33,0,-33
11555,1,0,65,0,-65
11556,1,1,329,1443,1114
11557,1,0,9,0,-9
11558,1,1,1088,1861,773
11559,1,1,898,1410,512
11560,0,0,5,0,-5
11561,1,1,199,2035,1836
11562,0,0,41,0,-41
11563,1,1,502,1603,1101
11564,1,1,154,1430,1276
11565,0,0,137,0,-137
11566,1,0,187,0,-187
11567,1,0,20,0,-20
11568,0,0,24,0,-24
11569,1,1,711,2783,2072
11570,0,0,29,0,-29
11571,0,0,68,0,-68
11572,1,1,540,1392,852
11573,0,0,67,0,-67
