ID,Флаг дозвона,Флаг продажи,Расходы,PV,NPV
0,0,0,4,0,-4
1,0,0,43,0,-43
2,1,1,87,1265,1178
3,1,1,116,1301,1185
4,1,0,67,0,-67
5,0,0,75,0,-75
6,0,0,115,0,-115
7,1,0,0,0,0
8,1,1,154,1792,1638
9,1,1,55,1202,1147
10,1,1,451,1580,1129
11,0,0,24,0,-24
12,1,0,8,0,-8
13,0,0,10,0,-10
14,0,0,90,0,-90
15,0,0,32,0,-32
16,1,1,889,1915,1026
17,1,1,24,1251,1227
18,0,0,36,0,-36
19,1,0,38,0,-38
20,1,1,473,1571,1098
21,0,0,6,0,-6
22,0,0,3,0,-3
23,0,0,2,0,-2
24,0,0,13,0,-13
25,1,1,550,1544,994
26,0,0,110,0,-110
27,1,0,57,0,-57
28,0,0,21,0,-21
29,1,1,307,1587,1280
30,0,0,122,0,-122
31,1,0,5,0,-5
32,0,0,11,0,-11
33,1,0,26,0,-26
34,0,0,10,0,-10
35,1,1,280,1861,1581
36,0,0,2,0,-2
37,0,0,146,0,-146
38,1,1,1275,1325,50
39,1,1,113,1330,1217
40,1,1,225,1698,1473
41,1,0,29,0,-29
42,1,0,9,0,-9
43,0,0,4,0,-4
44,0,0,21,0,-21
45,1,0,16,0,-16
46,1,0,88,0,-88
47,1,0,94,0,-94
48,1,0,63,0,-63
49,1,1,889,1972,1083
50,1,1,380,1446,1066
51,1,0,40,0,-40
52,0,0,11,0,-11
53,1,0,86,0,-86
54,1,1,1129,1776,647
55,1,0,4,0,-4
56,1,1,271,1326,1055
57,1,1,324,1302,978
58,0,0,7,0,-7
59,1,1,433,1566,1133
60,1,0,82,0,-82
61,1,1,699,1673,974
62,1,1,179,1345,1166
63,1,0,0,0,0
64,1,1,233,1325,1092
65,1,0,107,0,-107
66,1,0,11,0,-11
67,1,1,181,1789,1608
68,1,0,13,0,-13
69,1,0,43,0,-43
70,0,0,97,0,-97
71,1,1,1785,1637,-148
72,1,1,899,1391,492
73,0,0,23,0,-23
74,1,0,47,0,-47
75,1,0,19,0,-19
76,1,1,174,1715,1541
77,0,0,4,0,-4
78,1,1,312,1257,945
79,1,0,143,0,-143
80,0,0,2,0,-2
81,1,1,281,1389,1108
82,0,0,11,0,-11
83,1,0,24,0,-24
84,1,0,64,0,-64
85,0,0,10,0,-10
86,0,0,0,0,0
87,0,0,133,0,-133
88,0,0,3,0,-3
89,0,0,4,0,-4
90,0,0,1,0,-1
91,0,0,89,0,-89
92,1,0,25,0,-25
93,1,1,397,1869,1472
94,0,0,201,0,-201
95,0,0,40,0,-40
96,1,1,1054,2012,958
97,0,0,2,0,-2
98,1,0,5,0,-5
99,1,1,329,1254,925
100,0,0,24,0,-24
101,1,0,8,0,-8
102,0,0,18,0,-18
103,1,0,5,0,-5
104,0,0,8,0,-8
105,1,1,296,1742,1446
106,1,0,3,0,-3
107,1,1,1701,1322,-379
108,0,0,6,0,-6
109,1,1,276,2067,1791
110,0,0,57,0,-57
111,0,0,89,0,-89
112,1,1,159,1358,1199
113,1,0,101,0,-101
114,0,0,69,0,-69
115,0,0,7,0,-7
116,1,0,13,0,-13
117,1,0,172,0,-172
118,1,0,3,0,-3
119,1,0,78,0,-78
120,1,1,815,1376,561
121,1,1,293,1461,1168
122,1,0,44,0,-44
123,0,0,25,0,-25
124,0,0,32,0,-32
125,1,1,663,1273,610
126,0,0,36,0,-36
127,1,0,85,0,-85
128,0,0,46,0,-46
129,1,0,98,0,-98
130,0,0,71,0,-71
131,1,1,106,3115,3009
132,0,0,23,0,-23
133,1,0,228,0,-228
134,1,1,583,1729,1146
135,1,0,58,0,-58
136,0,0,137,0,-137
137,0,0,24,0,-24
138,0,0,244,0,-244
139,1,1,1092,1343,251
140,0,0,11,0,-11
141,1,1,181,1564,1383
142,1,1,903,1277,374
143,1,0,10,0,-10
144,1,1,278,1349,1071
145,1,1,762,1776,1014
146,0,0,11,0,-11
147,1,0,63,0,-63
148,0,0,9,0,-9
149,0,0,18,0,-18
150,0,0,36,0,-36
151,0,0,18,0,-18
152,1,0,24,0,-24
153,0,0,58,0,-58
154,0,0,111,0,-111
155,1,1,203,4436,4233
156,1,0,55,0,-55
157,1,0,63,0,-63
158,1,1,1373,2234,861
159,1,1,448,1504,1056
160,1,1,119,1570,1451
161,1,0,99,0,-99
162,1,1,144,1346,1202
163,1,1,1333,1239,-94
164,1,1,247,1300,1053
165,1,0,94,0,-94
166,1,0,133,0,-133
167,0,0,9,0,-9
168,1,1,201,1462,1261
169,1,1,1054,1638,584
170,0,0,90,0,-90
171,0,0,57,0,-57
172,1,1,816,1432,616
173,0,0,41,0,-41
174,0,0,18,0,-18
175,1,1,337,1284,947
176,1,1,51,2755,2704
177,1,1,248,2223,1975
178,0,0,22,0,-22
179,1,1,252,1693,1441
180,1,0,24,0,-24
181,1,0,41,0,-41
182,0,0,24,0,-24
183,1,0,23,0,-23
184,1,0,18,0,-18
185,1,1,197,2032,1835
186,0,0,78,0,-78
187,1,0,13,0,-13
188,1,1,89,1240,1151
189,0,0,51,0,-51
190,0,0,51,0,-51
191,1,1,763,1707,944
192,1,0,44,0,-44
193,1,1,163,1437,1274
194,1,0,17,0,-17
195,1,0,57,0,-57
196,1,0,19,0,-19
197,1,0,28,0,-28
198,1,0,35,0,-35
199,0,0,1,0,-1
200,1,1,194,1751,1557
201,1,1,1528,1370,-158
202,0,0,43,0,-43
203,1,1,291,1554,1263
204,1,1,836,1289,453
205,0,0,33,0,-33
206,0,0,1,0,-1
207,0,0,7,0,-7
208,1,0,78,0,-78
209,0,0,23,0,-23
210,0,0,51,0,-51
211,0,0,53,0,-53
212,0,0,21,0,-21
213,0,0,113,0,-113
214,0,0,7,0,-7
215,1,1,173,5717,5544
216,0,0,1,0,-1
217,1,1,625,1467,842
218,0,0,144,0,-144
219,1,0,31,0,-31
220,0,0,20,0,-20
221,0,0,12,0,-12
222,1,0,101,0,-101
223,0,0,3,0,-3
224,1,1,165,1549,1384
225,1,0,63,0,-63
226,1,0,61,0,-61
227,1,0,53,0,-53
228,1,0,49,0,-49
229,1,1,765,1331,566
230,1,0,7,0,-7
231,1,1,254,1203,949
232,0,0,0,0,0
233,1,1,929,2559,1630
234,1,1,626,1389,763
235,0,0,166,0,-166
236,1,0,12,0,-12
237,1,0,10,0,-10
238,1,1,677,1316,639
239,1,1,117,1720,1603
240,1,0,24,0,-24
241,1,1,369,1750,1381
242,0,0,9,0,-9
243,0,0,16,0,-16
244,0,0,59,0,-59
245,0,0,25,0,-25
246,1,1,752,2577,1825
247,1,0,109,0,-109
248,1,0,48,0,-48
249,1,0,23,0,-23
250,1,1,1056,1349,293
251,0,0,1,0,-1
252,1,1,190,1225,1035
253,1,1,797,1253,456
254,1,0,120,0,-120
255,0,0,72,0,-72
256,0,0,24,0,-24
257,1,0,28,0,-28
258,1,0,9,0,-9
259,1,1,676,2097,1421
260,1,0,104,0,-104
261,1,0,44,0,-44
262,1,1,773,1728,955
263,0,0,0,0,0
264,1,0,17,0,-17
265,0,0,16,0,-16
266,0,0,2,0,-2
267,1,1,204,1395,1191
268,0,0,54,0,-54
269,1,1,112,1362,1250
270,0,0,14,0,-14
271,0,0,140,0,-140
272,1,1,393,1718,1325
273,1,1,431,1260,829
274,0,0,8,0,-8
275,1,0,167,0,-167
276,1,0,3,0,-3
277,0,0,17,0,-17
278,1,1,879,1242,363
279,1,1,632,1407,775
280,0,0,102,0,-102
281,0,0,53,0,-53
282,0,0,29,0,-29
283,0,0,60,0,-60
284,0,0,61,0,-61
285,1,0,50,0,-50
286,0,0,19,0,-19
287,1,0,11,0,-11
288,0,0,80,0,-80
289,0,0,116,0,-116
290,1,1,2088,1258,-830
291,1,1,1578,1733,155
292,1,1,818,2083,1265
293,1,1,1212,1379,167
294,1,0,132,0,-132
295,1,1,278,1361,1083
296,1,1,1249,1374,125
297,0,0,5,0,-5
298,1,1,85,1363,1278
299,0,0,249,0,-249
300,1,0,194,0,-194
301,0,0,120,0,-120
302,0,0,61,0,-61
303,1,0,19,0,-19
304,0,0,83,0,-83
305,0,0,32,0,-32
306,1,1,134,1467,1333
307,0,0,8,0,-8
308,1,1,1903,1419,-484
309,1,0,22,0,-22
310,1,0,30,0,-30
311,0,0,205,0,-205
312,0,0,87,0,-87
313,0,0,26,0,-26
314,0,0,113,0,-113
315,0,0,11,0,-11
316,0,0,20,0,-20
317,1,0,37,0,-37
318,1,0,112,0,-112
319,0,0,162,0,-162
320,0,0,25,0,-25
321,1,1,453,1294,841
322,0,0,86,0,-86
323,1,0,328,0,-328
324,0,0,58,0,-58
325,0,0,36,0,-36
326,1,1,56,1299,1243
327,0,0,8,0,-8
328,0,0,19,0,-19
329,0,0,0,0,0
330,1,1,410,2818,2408
331,1,0,48,0,-48
332,0,0,66,0,-66
333,1,0,32,0,-32
334,1,0,50,0,-50
335,1,1,1092,2363,1271
336,1,1,511,1271,760
337,1,1,343,1408,1065
338,1,0,51,0,-51
339,0,0,16,0,-16
340,1,0,69,0,-69
341,1,1,565,2328,1763
342,1,0,28,0,-28
343,1,1,165,1336,1171
344,0,0,0,0,0
345,0,0,292,0,-292
346,1,0,18,0,-18
347,1,1,508,1240,732
348,0,0,42,0,-42
349,0,0,175,0,-175
350,1,0,98,0,-98
351,1,0,38,0,-38
352,1,0,83,0,-83
353,1,0,123,0,-123
354,0,0,53,0,-53
355,1,1,674,1741,1067
356,0,0,77,0,-77
357,1,1,404,2094,1690
358,1,0,40,0,-40
359,0,0,14,0,-14
360,1,0,53,0,-53
361,0,0,8,0,-8
362,1,0,25,0,-25
363,1,1,14,2348,2334
364,0,0,88,0,-88
365,1,1,82,1342,1260
366,1,0,183,0,-183
367,1,0,27,0,-27
368,0,0,103,0,-103
369,0,0,200,0,-200
370,1,0,40,0,-40
371,1,0,3,0,-3
372,0,0,40,0,-40
373,0,0,25,0,-25
374,0,0,4,0,-4
375,1,1,31,1344,1313
376,1,1,22,1706,1684
377,1,1,40,1248,1208
378,0,0,21,0,-21
379,1,1,562,1308,746
380,0,0,53,0,-53
381,1,0,34,0,-34
382,1,1,40,1427,1387
383,1,1,413,2093,1680
384,1,0,15,0,-15
385,1,0,54,0,-54
386,1,0,130,0,-130
387,1,0,78,0,-78
388,0,0,25,0,-25
389,0,0,26,0,-26
390,1,1,184,1786,1602
391,1,1,1173,1263,90
392,1,0,8,0,-8
393,1,1,352,1409,1057
394,1,1,298,1445,1147
395,0,0,72,0,-72
396,0,0,127,0,-127
397,0,0,72,0,-72
398,0,0,15,0,-15
399,1,1,141,1228,1087
400,1,0,1,0,-1
401,1,1,251,1256,1005
402,0,0,0,0,0
403,1,1,312,1355,1043
404,1,0,9,0,-9
405,1,0,77,0,-77
406,1,1,328,1382,1054
407,0,0,19,0,-19
408,0,0,175,0,-175
409,1,0,14,0,-14
410,1,0,55,0,-55
411,1,1,979,1307,328
412,1,0,41,0,-41
413,1,0,48,0,-48
414,1,1,1242,1477,235
415,1,0,43,0,-43
416,0,0,26,0,-26
417,0,0,23,0,-23
418,0,0,5,0,-5
419,0,0,138,0,-138
420,1,0,13,0,-13
421,1,1,55,1335,1280
422,1,1,860,3425,2565
423,1,1,377,1317,940
424,0,0,51,0,-51
425,0,0,36,0,-36
426,1,0,9,0,-9
427,1,0,98,0,-98
428,1,1,606,1395,789
429,1,0,14,0,-14
430,1,1,98,1729,1631
431,1,1,245,1331,1086
432,1,1,370,1397,1027
433,0,0,10,0,-10
434,0,0,14,0,-14
435,0,0,6,0,-6
436,0,0,22,0,-22
437,0,0,77,0,-77
438,1,0,27,0,-27
439,0,0,56,0,-56
440,0,0,93,0,-93
441,0,0,30,0,-30
442,0,0,78,0,-78
443,0,0,24,0,-24
444,1,1,553,1209,656
445,1,1,632,2426,1794
446,1,1,112,1345,1233
447,1,0,51,0,-51
448,1,0,25,0,-25
449,1,0,0,0,0
450,1,0,7,0,-7
451,0,0,120,0,-120
452,1,1,599,1306,707
453,1,0,97,0,-97
454,0,0,78,0,-78
455,1,1,316,1569,1253
456,1,1,419,1421,1002
457,1,0,85,0,-85
458,0,0,2,0,-2
459,1,0,7,0,-7
460,1,1,630,1307,677
461,0,0,8,0,-8
462,1,0,92,0,-92
463,1,1,468,1480,1012
464,1,0,78,0,-78
465,0,0,26,0,-26
466,0,0,16,0,-16
467,0,0,56,0,-56
468,0,0,21,0,-21
469,1,0,51,0,-51
470,0,0,2,0,-2
471,1,1,126,2314,2188
472,0,0,2,0,-2
473,0,0,100,0,-100
474,0,0,11,0,-11
475,0,0,37,0,-37
476,1,0,104,0,-104
477,1,0,9,0,-9
478,0,0,42,0,-42
479,1,1,168,2030,1862
480,0,0,44,0,-44
481,0,0,8,0,-8
482,1,1,101,3064,2963
483,0,0,63,0,-63
484,1,0,15,0,-15
485,0,0,38,0,-38
486,0,0,6,0,-6
487,1,1,1392,2603,1211
488,0,0,29,0,-29
489,0,0,38,0,-38
490,0,0,17,0,-17
491,1,1,62,1345,1283
492,1,1,562,1801,1239
493,1,1,335,1520,1185
494,1,0,57,0,-57
495,0,0,82,0,-82
496,1,1,244,1213,969
497,1,0,30,0,-30
498,1,0,38,0,-38
499,0,0,174,0,-174
500,0,0,11,0,-11
501,1,1,156,1775,1619
502,1,1,579,1595,1016
503,0,0,143,0,-143
504,1,0,10,0,-10
505,0,0,227,0,-227
506,1,0,54,0,-54
507,0,0,43,0,-43
508,1,0,5,0,-5
509,1,1,156,2180,2024
510,1,1,182,1607,1425
511,1,0,65,0,-65
512,1,1,764,3532,2768
513,1,1,111,1510,1399
514,0,0,17,0,-17
515,1,0,19,0,-19
516,0,0,128,0,-128
517,0,0,135,0,-135
518,0,0,95,0,-95
519,0,0,52,0,-52
520,0,0,44,0,-44
521,1,1,226,1457,1231
522,0,0,119,0,-119
523,0,0,12,0,-12
524,1,1,42,1329,1287
525,1,0,233,0,-233
526,1,0,34,0,-34
527,1,0,7,0,-7
528,0,0,98,0,-98
529,1,1,468,1345,877
530,1,1,255,1273,1018
531,1,1,1704,1763,59
532,1,1,82,1209,1127
533,1,1,198,1284,1086
534,1,0,77,0,-77
535,1,0,77,0,-77
536,0,0,35,0,-35
537,1,1,522,1270,748
538,1,1,786,1235,449
539,1,0,29,0,-29
540,1,0,27,0,-27
541,0,0,17,0,-17
542,0,0,94,0,-94
543,0,0,137,0,-137
544,0,0,24,0,-24
545,1,0,0,0,0
546,1,0,37,0,-37
547,0,0,65,0,-65
548,0,0,3,0,-3
549,1,1,370,2686,2316
550,1,0,101,0,-101
551,1,1,563,1242,679
552,0,0,2,0,-2
553,1,1,518,1215,697
554,0,0,188,0,-188
555,1,0,25,0,-25
556,1,0,39,0,-39
557,1,1,676,1209,533
558,0,0,24,0,-24
559,0,0,4,0,-4
560,1,0,1,0,-1
561,0,0,29,0,-29
562,1,0,24,0,-24
563,0,0,61,0,-61
564,0,0,72,0,-72
565,0,0,30,0,-30
566,0,0,68,0,-68
567,1,1,193,1611,1418
568,1,0,43,0,-43
569,1,0,105,0,-105
570,1,1,345,1554,1209
571,0,0,8,0,-8
572,1,0,90,0,-90
573,0,0,46,0,-46
574,1,0,40,0,-40
575,0,0,71,0,-71
576,1,1,640,1634,994
577,0,0,2,0,-2
578,1,0,182,0,-182
579,1,0,100,0,-100
580,1,0,15,0,-15
581,0,0,23,0,-23
582,0,0,16,0,-16
583,1,0,67,0,-67
584,1,1,324,1282,958
585,1,0,7,0,-7
586,1,0,72,0,-72
587,1,1,398,1622,1224
588,0,0,40,0,-40
589,1,1,495,1710,1215
590,0,0,28,0,-28
591,0,0,18,0,-18
592,1,1,99,2309,2210
593,0,0,251,0,-251
594,1,0,47,0,-47
595,0,0,6,0,-6
596,1,0,2,0,-2
597,1,1,548,1484,936
598,1,0,6,0,-6
599,0,0,59,0,-59
600,1,0,51,0,-51
601,1,1,224,1458,1234
602,1,0,21,0,-21
603,0,0,154,0,-154
604,1,0,24,0,-24
605,0,0,89,0,-89
606,0,0,115,0,-115
607,0,0,61,0,-61
608,1,0,21,0,-21
609,0,0,2,0,-2
610,0,0,110,0,-110
611,1,1,2866,1831,-1035
612,0,0,26,0,-26
613,0,0,73,0,-73
614,1,0,9,0,-9
615,0,0,54,0,-54
616,0,0,72,0,-72
617,1,1,119,1413,1294
618,0,0,2,0,-2
619,1,0,132,0,-132
620,1,1,1143,1275,132
621,1,1,131,1390,1259
622,0,0,33,0,-33
623,1,0,110,0,-110
624,1,1,508,1674,1166
625,1,0,85,0,-85
626,1,1,1290,2902,1612
627,0,0,129,0,-129
628,1,1,1059,2067,1008
629,1,0,158,0,-158
630,0,0,20,0,-20
631,0,0,49,0,-49
632,1,0,34,0,-34
633,0,0,30,0,-30
634,0,0,44,0,-44
635,1,0,87,0,-87
636,0,0,41,0,-41
637,1,1,806,1230,424
638,1,1,64,1259,1195
639,1,0,63,0,-63
640,0,0,7,0,-7
641,1,0,34,0,-34
642,1,1,884,1265,381
643,1,0,65,0,-65
644,0,0,26,0,-26
645,0,0,24,0,-24
646,1,0,8,0,-8
647,1,0,44,0,-44
648,0,0,23,0,-23
649,1,0,34,0,-34
650,0,0,32,0,-32
651,0,0,57,0,-57
652,1,1,160,2878,2718
653,0,0,89,0,-89
654,0,0,36,0,-36
655,0,0,16,0,-16
656,1,0,10,0,-10
657,0,0,74,0,-74
658,1,1,600,1622,1022
659,1,1,331,1901,1570
660,1,1,690,1274,584
661,1,0,37,0,-37
662,1,1,216,1219,1003
663,0,0,24,0,-24
664,0,0,81,0,-81
665,0,0,42,0,-42
666,0,0,76,0,-76
667,1,0,6,0,-6
668,1,0,76,0,-76
669,0,0,25,0,-25
670,0,0,25,0,-25
671,0,0,2,0,-2
672,0,0,152,0,-152
673,1,1,656,1320,664
674,0,0,105,0,-105
675,1,0,2,0,-2
676,0,0,8,0,-8
677,0,0,68,0,-68
678,1,0,90,0,-90
679,1,1,197,2229,2032
680,1,1,61,1828,1767
681,1,0,4,0,-4
682,1,0,43,0,-43
683,1,1,1317,1668,351
684,1,0,116,0,-116
685,0,0,12,0,-12
686,0,0,79,0,-79
687,1,0,74,0,-74
688,1,0,11,0,-11
689,0,0,13,0,-13
690,0,0,61,0,-61
691,0,0,92,0,-92
692,0,0,11,0,-11
693,0,0,92,0,-92
694,1,0,201,0,-201
695,0,0,36,0,-36
696,0,0,0,0,0
697,1,0,67,0,-67
698,1,1,785,3032,2247
699,1,1,130,1232,1102
700,1,1,1938,1371,-567
701,0,0,18,0,-18
702,1,0,102,0,-102
703,1,0,59,0,-59
704,0,0,10,0,-10
705,1,0,69,0,-69
706,1,0,102,0,-102
707,0,0,67,0,-67
708,1,0,244,0,-244
709,1,1,387,1671,1284
710,0,0,65,0,-65
711,1,0,2,0,-2
712,1,1,29,2349,2320
713,1,1,794,2322,1528
714,0,0,8,0,-8
715,1,0,28,0,-28
716,1,1,238,1374,1136
717,0,0,34,0,-34
718,0,0,41,0,-41
719,0,0,2,0,-2
720,1,1,111,1259,1148
721,0,0,58,0,-58
722,1,0,0,0,0
723,1,1,153,1220,1067
724,0,0,12,0,-12
725,0,0,22,0,-22
726,1,1,1255,1260,5
727,0,0,0,0,0
728,0,0,50,0,-50
729,1,0,110,0,-110
730,0,0,198,0,-198
731,0,0,21,0,-21
732,1,1,1540,1224,-316
733,0,0,10,0,-10
734,1,0,35,0,-35
735,1,1,90,2149,2059
736,1,0,40,0,-40
737,0,0,9,0,-9
738,0,0,37,0,-37
739,0,0,79,0,-79
740,1,0,71,0,-71
741,0,0,128,0,-128
742,0,0,115,0,-115
743,0,0,47,0,-47
744,0,0,64,0,-64
745,1,1,941,1732,791
746,1,1,624,1326,702
747,1,1,2222,1435,-787
748,0,0,0,0,0
749,1,0,126,0,-126
750,0,0,51,0,-51
751,1,0,17,0,-17
752,1,1,307,1362,1055
753,1,1,656,1435,779
754,1,0,24,0,-24
755,1,1,229,1659,1430
756,1,1,118,1249,1131
757,1,0,9,0,-9
758,0,0,19,0,-19
759,0,0,27,0,-27
760,1,0,257,0,-257
761,1,1,341,1384,1043
762,1,1,2148,1387,-761
763,1,0,12,0,-12
764,1,1,762,1702,940
765,1,0,41,0,-41
766,0,0,9,0,-9
767,0,0,45,0,-45
768,1,1,2433,2150,-283
769,1,1,2078,1241,-837
770,0,0,84,0,-84
771,0,0,23,0,-23
772,1,0,115,0,-115
773,0,0,32,0,-32
774,1,0,26,0,-26
775,1,0,155,0,-155
776,0,0,18,0,-18
777,1,1,562,1304,742
778,1,0,78,0,-78
779,0,0,41,0,-41
780,1,0,106,0,-106
781,1,0,2,0,-2
782,1,0,95,0,-95
783,0,0,123,0,-123
784,0,0,37,0,-37
785,1,0,46,0,-46
786,0,0,1,0,-1
787,0,0,45,0,-45
788,1,0,82,0,-82
789,1,1,1098,1871,773
790,1,1,1402,1304,-98
791,1,1,98,1224,1126
792,1,1,777,1233,456
793,0,0,5,0,-5
794,1,1,222,1329,1107
795,1,0,134,0,-134
796,0,0,32,0,-32
797,1,1,1166,2423,1257
798,1,0,48,0,-48
799,1,1,271,1599,1328
800,1,1,1451,1306,-145
801,0,0,20,0,-20
802,1,0,77,0,-77
803,1,1,650,1820,1170
804,0,0,1,0,-1
805,1,1,138,3434,3296
806,1,1,137,1203,1066
807,1,0,32,0,-32
808,0,0,70,0,-70
809,1,1,114,1591,1477
810,1,0,41,0,-41
811,0,0,8,0,-8
812,1,0,9,0,-9
813,0,0,69,0,-69
814,0,0,80,0,-80
815,1,0,27,0,-27
816,1,0,71,0,-71
817,0,0,37,0,-37
818,0,0,16,0,-16
819,0,0,213,0,-213
820,1,0,20,0,-20
821,0,0,6,0,-6
822,0,0,72,0,-72
823,0,0,43,0,-43
824,1,1,1089,1999,910
825,0,0,3,0,-3
826,1,1,460,1966,1506
827,0,0,15,0,-15
828,1,1,74,1294,1220
829,1,1,199,1547,1348
830,1,0,54,0,-54
831,1,0,4,0,-4
832,0,0,31,0,-31
833,1,1,981,1383,402
834,1,1,235,1313,1078
835,1,1,1130,1271,141
836,1,0,5,0,-5
837,1,1,424,1436,1012
838,1,1,374,1454,1080
839,0,0,61,0,-61
840,1,0,67,0,-67
841,1,1,132,1316,1184
842,1,0,62,0,-62
843,0,0,17,0,-17
844,0,0,93,0,-93
845,1,1,774,1467,693
846,1,1,1061,1331,270
847,0,0,19,0,-19
848,1,1,512,4123,3611
849,1,0,31,0,-31
850,0,0,3,0,-3
851,0,0,8,0,-8
852,0,0,46,0,-46
853,1,1,134,1873,1739
854,0,0,58,0,-58
855,1,0,7,0,-7
856,0,0,7,0,-7
857,0,0,6,0,-6
858,1,0,3,0,-3
859,1,1,713,1242,529
860,1,1,307,2049,1742
861,0,0,7,0,-7
862,0,0,22,0,-22
863,1,0,3,0,-3
864,0,0,18,0,-18
865,1,0,76,0,-76
866,0,0,3,0,-3
867,0,0,77,0,-77
868,1,1,355,1610,1255
869,1,0,24,0,-24
870,0,0,3,0,-3
871,1,0,23,0,-23
872,1,1,241,4121,3880
873,1,1,282,1993,1711
874,0,0,32,0,-32
875,1,1,700,1485,785
876,1,1,1312,1436,124
877,1,0,46,0,-46
878,1,1,422,1334,912
879,1,0,72,0,-72
880,0,0,122,0,-122
881,1,0,16,0,-16
882,1,1,926,1353,427
883,1,0,38,0,-38
884,1,0,8,0,-8
885,0,0,21,0,-21
886,0,0,3,0,-3
887,0,0,15,0,-15
888,0,0,23,0,-23
889,1,1,70,1314,1244
890,0,0,214,0,-214
891,0,0,8,0,-8
892,0,0,1,0,-1
893,1,1,215,1369,1154
894,1,0,11,0,-11
895,1,1,238,1238,1000
896,0,0,59,0,-59
897,0,0,27,0,-27
898,1,1,2052,1768,-284
899,0,0,8,0,-8
900,0,0,46,0,-46
901,0,0,7,0,-7
902,0,0,19,0,-19
903,0,0,24,0,-24
904,1,0,23,0,-23
905,1,0,83,0,-83
906,1,1,270,1456,1186
907,1,1,310,1576,1266
908,0,0,10,0,-10
909,1,0,80,0,-80
910,1,1,1089,1291,202
911,1,0,27,0,-27
912,1,0,23,0,-23
913,1,1,810,1373,563
914,1,0,28,0,-28
915,1,1,596,1794,1198
916,1,1,1094,1714,620
917,1,0,15,0,-15
918,0,0,24,0,-24
919,1,0,110,0,-110
920,1,1,33,1261,1228
921,1,1,235,1430,1195
922,1,1,348,1279,931
923,1,1,587,1236,649
924,1,0,111,0,-111
925,0,0,182,0,-182
926,1,0,92,0,-92
927,0,0,140,0,-140
928,1,1,385,1451,1066
929,1,1,425,2579,2154
930,0,0,119,0,-119
931,1,1,585,1292,707
932,0,0,14,0,-14
933,0,0,61,0,-61
934,1,1,418,1275,857
935,1,1,661,1552,891
936,1,1,1998,1390,-608
937,0,0,9,0,-9
938,0,0,196,0,-196
939,0,0,0,0,0
940,0,0,101,0,-101
941,0,0,47,0,-47
942,0,0,131,0,-131
943,0,0,17,0,-17
944,1,0,22,0,-22
945,1,1,1199,1242,43
946,0,0,24,0,-24
947,1,1,263,1211,948
948,1,0,92,0,-92
949,1,0,141,0,-141
950,1,0,5,0,-5
951,1,1,623,1409,786
952,1,1,367,1255,888
953,0,0,57,0,-57
954,1,0,22,0,-22
955,0,0,25,0,-25
956,1,0,3,0,-3
957,1,1,328,1600,1272
958,1,1,963,1281,318
959,1,1,933,1759,826
960,0,0,2,0,-2
961,1,1,784,2152,1368
962,0,0,21,0,-21
963,1,1,306,1210,904
964,1,0,62,0,-62
965,1,0,52,0,-52
966,1,1,683,1944,1261
967,1,0,74,0,-74
968,0,0,21,0,-21
969,1,1,294,1238,944
970,1,1,452,1249,797
971,0,0,60,0,-60
972,0,0,18,0,-18
973,0,0,75,0,-75
974,0,0,68,0,-68
975,1,0,82,0,-82
976,0,0,44,0,-44
977,0,0,30,0,-30
978,0,0,5,0,-5
979,0,0,32,0,-32
980,1,1,427,1246,819
981,0,0,53,0,-53
982,1,0,7,0,-7
983,1,0,27,0,-27
984,0,0,23,0,-23
985,1,0,18,0,-18
986,1,1,68,4460,4392
987,0,0,45,0,-45
988,0,0,70,0,-70
989,0,0,9,0,-9
990,0,0,54,0,-54
991,1,0,20,0,-20
992,1,1,111,1662,1551
993,1,1,185,1734,1549
994,1,1,839,1409,570
995,1,0,64,0,-64
996,1,0,134,0,-134
997,1,0,32,0,-32
998,0,0,26,0,-26
999,0,0,45,0,-45
1000,0,0,77,0,-77
1001,0,0,119,0,-119
1002,1,0,85,0,-85
1003,0,0,98,0,-98
1004,1,0,11,0,-11
1005,1,1,204,1220,1016
1006,1,0,124,0,-124
1007,1,1,1212,1491,279
1008,0,0,5,0,-5
1009,1,1,639,1496,857
1010,0,0,6,0,-6
1011,1,1,248,1422,1174
1012,1,0,24,0,-24
1013,1,0,23,0,-23
1014,0,0,26,0,-26
1015,1,1,3791,2397,-1394
1016,0,0,36,0,-36
1017,1,1,1084,1261,177
1018,1,0,3,0,-3
1019,0,0,12,0,-12
1020,1,1,470,1320,850
1021,0,0,103,0,-103
1022,1,0,10,0,-10
1023,1,1,264,1443,1179
1024,1,0,154,0,-154
1025,1,1,271,1789,1518
1026,0,0,161,0,-161
1027,0,0,47,0,-47
1028,1,0,41,0,-41
1029,1,1,605,1478,873
1030,1,0,60,0,-60
1031,1,1,420,1795,1375
1032,1,1,622,1200,578
1033,0,0,20,0,-20
1034,0,0,5,0,-5
1035,1,1,178,1238,1060
1036,1,1,845,2212,1367
1037,0,0,12,0,-12
1038,0,0,63,0,-63
1039,0,0,36,0,-36
1040,1,0,56,0,-56
1041,1,1,96,1300,1204
1042,0,0,21,0,-21
1043,1,0,54,0,-54
1044,0,0,41,0,-41
1045,0,0,4,0,-4
1046,0,0,1,0,-1
1047,0,0,42,0,-42
1048,0,0,9,0,-9
1049,0,0,3,0,-3
1050,1,1,940,1423,483
1051,0,0,0,0,0
1052,0,0,5,0,-5
1053,0,0,29,0,-29
1054,1,0,40,0,-40
1055,1,0,63,0,-63
1056,1,1,421,1473,1052
1057,1,1,1265,1583,318
1058,1,1,133,1314,1181
1059,0,0,115,0,-115
1060,1,1,1315,1237,-78
1061,0,0,121,0,-121
1062,0,0,18,0,-18
1063,1,0,288,0,-288
1064,1,1,124,1457,1333
1065,1,0,27,0,-27
1066,1,1,126,1354,1228
1067,0,0,28,0,-28
1068,1,0,1,0,-1
1069,0,0,64,0,-64
1070,0,0,10,0,-10
1071,0,0,13,0,-13
1072,0,0,53,0,-53
1073,0,0,131,0,-131
1074,0,0,14,0,-14
1075,1,0,11,0,-11
1076,1,1,168,1870,1702
1077,1,0,137,0,-137
1078,1,1,118,1410,1292
1079,1,0,0,0,0
1080,1,0,35,0,-35
1081,0,0,2,0,-2
1082,0,0,74,0,-74
1083,0,0,45,0,-45
1084,0,0,0,0,0
1085,1,0,26,0,-26
1086,0,0,120,0,-120
1087,0,0,85,0,-85
1088,1,0,88,0,-88
1089,0,0,102,0,-102
1090,0,0,1,0,-1
1091,0,0,131,0,-131
1092,1,1,680,1384,704
1093,1,0,100,0,-100
1094,0,0,14,0,-14
1095,1,1,319,1280,961
1096,0,0,87,0,-87
1097,1,0,153,0,-153
1098,0,0,42,0,-42
1099,1,0,22,0,-22
1100,0,0,6,0,-6
1101,1,1,1563,1239,-324
1102,1,1,254,1203,949
1103,1,1,3108,1260,-1848
1104,1,0,66,0,-66
1105,1,0,60,0,-60
1106,1,1,394,1495,1101
1107,1,1,1304,1339,35
1108,1,0,15,0,-15
1109,1,1,736,1527,791
1110,0,0,131,0,-131
1111,0,0,12,0,-12
1112,1,1,743,1255,512
1113,0,0,105,0,-105
1114,1,0,52,0,-52
1115,1,0,11,0,-11
1116,1,0,86,0,-86
1117,1,0,93,0,-93
1118,1,0,62,0,-62
1119,1,0,14,0,-14
1120,0,0,13,0,-13
1121,0,0,175,0,-175
1122,1,1,220,1494,1274
1123,0,0,66,0,-66
1124,0,0,30,0,-30
1125,1,1,149,1769,1620
1126,0,0,44,0,-44
1127,0,0,5,0,-5
1128,1,0,11,0,-11
1129,1,1,938,1815,877
1130,1,1,354,2751,2397
1131,1,1,215,1296,1081
1132,1,1,1122,1454,332
1133,1,1,994,1211,217
1134,0,0,22,0,-22
1135,0,0,0,0,0
1136,1,1,1348,2038,690
1137,1,0,133,0,-133
1138,1,0,41,0,-41
1139,0,0,27,0,-27
1140,1,1,1608,1993,385
1141,0,0,4,0,-4
1142,1,1,365,1660,1295
1143,0,0,129,0,-129
1144,0,0,17,0,-17
1145,1,0,57,0,-57
1146,1,0,4,0,-4
1147,0,0,52,0,-52
1148,0,0,16,0,-16
1149,0,0,170,0,-170
1150,1,0,23,0,-23
1151,1,1,464,1614,1150
1152,1,0,4,0,-4
1153,0,0,4,0,-4
1154,0,0,181,0,-181
1155,0,0,39,0,-39
1156,0,0,48,0,-48
1157,1,1,336,1464,1128
1158,1,1,836,1219,383
1159,0,0,20,0,-20
1160,0,0,57,0,-57
1161,0,0,76,0,-76
1162,1,0,114,0,-114
1163,0,0,76,0,-76
1164,1,1,180,1305,1125
1165,1,1,372,1322,950
1166,1,0,21,0,-21
1167,0,0,58,0,-58
1168,1,0,12,0,-12
1169,0,0,253,0,-253
1170,1,1,437,1262,825
1171,1,1,920,1265,345
1172,1,0,66,0,-66
1173,1,0,0,0,0
1174,1,1,279,1248,969
1175,1,0,4,0,-4
1176,1,0,69,0,-69
1177,0,0,142,0,-142
1178,1,1,1479,1254,-225
1179,1,0,50,0,-50
1180,1,1,141,1542,1401
1181,1,0,3,0,-3
1182,0,0,0,0,0
1183,1,0,84,0,-84
1184,1,0,93,0,-93
1185,1,1,506,1285,779
1186,1,0,132,0,-132
1187,0,0,20,0,-20
1188,0,0,13,0,-13
1189,1,0,20,0,-20
1190,0,0,68,0,-68
1191,1,0,18,0,-18
1192,1,0,77,0,-77
1193,1,1,643,1661,1018
1194,0,0,18,0,-18
1195,1,0,32,0,-32
1196,0,0,86,0,-86
1197,0,0,17,0,-17
1198,0,0,25,0,-25
1199,1,0,32,0,-32
1200,1,1,729,1612,883
1201,0,0,9,0,-9
1202,0,0,2,0,-2
1203,0,0,11,0,-11
1204,1,0,2,0,-2
1205,0,0,13,0,-13
1206,1,1,187,1279,1092
1207,1,0,25,0,-25
1208,1,0,87,0,-87
1209,1,0,32,0,-32
1210,1,1,491,1474,983
1211,0,0,33,0,-33
1212,1,1,290,1261,971
1213,0,0,29,0,-29
1214,1,0,36,0,-36
1215,0,0,25,0,-25
1216,0,0,21,0,-21
1217,1,1,1385,1436,51
1218,1,0,111,0,-111
1219,0,0,16,0,-16
1220,1,0,24,0,-24
1221,1,1,287,1222,935
1222,1,1,450,1273,823
1223,1,1,224,1589,1365
1224,0,0,95,0,-95
1225,1,1,120,1876,1756
1226,1,1,271,1399,1128
1227,1,0,0,0,0
1228,0,0,118,0,-118
1229,0,0,48,0,-48
1230,0,0,2,0,-2
1231,0,0,58,0,-58
1232,1,0,46,0,-46
1233,1,1,502,1376,874
1234,0,0,36,0,-36
1235,1,1,1248,1383,135
1236,1,0,4,0,-4
1237,0,0,172,0,-172
1238,1,1,834,1215,381
1239,0,0,1,0,-1
1240,1,0,0,0,0
1241,1,1,458,1318,860
1242,0,0,10,0,-10
1243,1,0,23,0,-23
1244,0,0,45,0,-45
1245,0,0,28,0,-28
1246,0,0,17,0,-17
1247,0,0,5,0,-5
1248,1,0,46,0,-46
1249,0,0,168,0,-168
1250,1,0,79,0,-79
1251,0,0,293,0,-293
1252,0,0,38,0,-38
1253,0,0,44,0,-44
1254,1,0,136,0,-136
1255,0,0,12,0,-12
1256,0,0,5,0,-5
1257,0,0,28,0,-28
1258,1,0,34,0,-34
1259,1,0,147,0,-147
1260,1,1,746,1585,839
1261,1,1,182,1614,1432
1262,0,0,267,0,-267
1263,0,0,45,0,-45
1264,0,0,59,0,-59
1265,0,0,85,0,-85
1266,1,0,28,0,-28
1267,0,0,41,0,-41
1268,0,0,3,0,-3
1269,1,1,81,1837,1756
1270,1,0,31,0,-31
1271,1,0,232,0,-232
1272,1,1,570,1544,974
1273,1,1,393,1466,1073
1274,0,0,105,0,-105
1275,1,1,332,1291,959
1276,0,0,39,0,-39
1277,1,1,126,1563,1437
1278,1,0,73,0,-73
1279,0,0,0,0,0
1280,1,0,3,0,-3
1281,1,1,524,1312,788
1282,1,0,181,0,-181
1283,0,0,66,0,-66
1284,0,0,26,0,-26
1285,1,0,10,0,-10
1286,1,1,81,2821,2740
1287,0,0,56,0,-56
1288,1,1,174,1290,1116
1289,1,0,14,0,-14
1290,0,0,111,0,-111
1291,1,0,100,0,-100
1292,1,0,3,0,-3
1293,1,1,401,2104,1703
1294,0,0,13,0,-13
1295,0,0,8,0,-8
1296,1,1,586,1252,666
1297,1,0,56,0,-56
1298,1,0,122,0,-122
1299,1,1,219,1728,1509
1300,1,0,16,0,-16
1301,1,1,396,1526,1130
1302,1,0,57,0,-57
1303,0,0,31,0,-31
1304,1,0,88,0,-88
1305,1,0,42,0,-42
1306,1,0,0,0,0
1307,1,1,500,1294,794
1308,1,1,109,1605,1496
1309,0,0,46,0,-46
1310,1,1,357,1602,1245
1311,1,1,20,1226,1206
1312,1,0,3,0,-3
1313,1,0,38,0,-38
1314,1,0,18,0,-18
1315,1,0,12,0,-12
1316,0,0,20,0,-20
1317,1,1,202,1238,1036
1318,1,1,607,1385,778
1319,0,0,94,0,-94
1320,1,0,6,0,-6
1321,1,1,424,1269,845
1322,1,0,109,0,-109
1323,1,0,93,0,-93
1324,0,0,66,0,-66
1325,0,0,25,0,-25
1326,0,0,6,0,-6
1327,1,1,291,1484,1193
1328,1,1,194,1416,1222
1329,1,1,126,1312,1186
1330,1,0,122,0,-122
1331,1,1,258,1695,1437
1332,1,1,534,2048,1514
1333,0,0,77,0,-77
1334,1,0,57,0,-57
1335,0,0,33,0,-33
1336,1,0,26,0,-26
1337,1,0,56,0,-56
1338,1,1,382,1266,884
1339,0,0,24,0,-24
1340,0,0,6,0,-6
1341,1,1,1657,1247,-410
1342,0,0,3,0,-3
1343,0,0,83,0,-83
1344,1,1,380,1525,1145
1345,0,0,48,0,-48
1346,0,0,42,0,-42
1347,0,0,226,0,-226
1348,1,0,165,0,-165
1349,1,0,23,0,-23
1350,1,1,130,1309,1179
1351,1,0,74,0,-74
1352,0,0,37,0,-37
1353,1,1,99,1237,1138
1354,1,0,53,0,-53
1355,1,0,1,0,-1
1356,0,0,1,0,-1
1357,0,0,61,0,-61
1358,1,1,505,1312,807
1359,1,1,1677,1426,-251
1360,1,1,1037,1207,170
1361,0,0,10,0,-10
1362,0,0,85,0,-85
1363,0,0,9,0,-9
1364,1,0,46,0,-46
1365,0,0,27,0,-27
1366,1,1,759,1733,974
1367,0,0,26,0,-26
1368,1,1,116,6087,5971
1369,1,0,12,0,-12
1370,0,0,2,0,-2
1371,0,0,18,0,-18
1372,0,0,2,0,-2
1373,1,0,54,0,-54
1374,0,0,42,0,-42
1375,1,1,266,1217,951
1376,1,1,580,1957,1377
1377,0,0,35,0,-35
1378,1,1,857,1361,504
1379,0,0,188,0,-188
1380,0,0,10,0,-10
1381,0,0,99,0,-99
1382,1,0,52,0,-52
1383,1,1,1709,2180,471
1384,1,1,298,1213,915
1385,1,1,227,1291,1064
1386,1,0,4,0,-4
1387,0,0,13,0,-13
1388,1,0,12,0,-12
1389,0,0,20,0,-20
1390,1,1,178,1375,1197
1391,0,0,1,0,-1
1392,1,1,106,1252,1146
1393,0,0,110,0,-110
1394,1,1,105,1328,1223
1395,1,1,597,1728,1131
1396,0,0,185,0,-185
1397,1,0,10,0,-10
1398,1,1,389,3220,2831
1399,1,0,37,0,-37
1400,0,0,22,0,-22
1401,1,1,481,1787,1306
1402,1,0,17,0,-17
1403,1,0,38,0,-38
1404,0,0,4,0,-4
1405,1,0,48,0,-48
1406,1,1,239,1348,1109
1407,1,0,37,0,-37
1408,1,1,324,1324,1000
1409,1,1,951,1842,891
1410,1,0,2,0,-2
1411,1,0,102,0,-102
1412,0,0,65,0,-65
1413,1,0,23,0,-23
1414,1,1,95,1264,1169
1415,1,1,146,1389,1243
1416,0,0,58,0,-58
1417,1,1,1977,1889,-88
1418,1,0,99,0,-99
1419,1,0,40,0,-40
1420,1,0,12,0,-12
1421,0,0,14,0,-14
1422,1,0,2,0,-2
1423,1,0,17,0,-17
1424,0,0,12,0,-12
1425,1,1,217,1586,1369
1426,1,1,1600,1238,-362
1427,0,0,7,0,-7
1428,1,1,149,1628,1479
1429,0,0,87,0,-87
1430,1,0,28,0,-28
1431,0,0,73,0,-73
1432,1,1,718,1291,573
1433,1,0,8,0,-8
1434,0,0,34,0,-34
1435,1,1,426,1464,1038
1436,0,0,24,0,-24
1437,1,1,662,1443,781
1438,0,0,20,0,-20
1439,1,0,38,0,-38
1440,1,0,11,0,-11
1441,0,0,2,0,-2
1442,1,1,103,1277,1174
1443,1,0,148,0,-148
1444,0,0,6,0,-6
1445,0,0,24,0,-24
1446,1,1,314,2399,2085
1447,0,0,119,0,-119
1448,0,0,31,0,-31
1449,0,0,9,0,-9
1450,1,0,56,0,-56
1451,1,1,416,1395,979
1452,0,0,10,0,-10
1453,1,1,338,1606,1268
1454,0,0,23,0,-23
1455,1,0,15,0,-15
1456,1,1,498,1687,1189
1457,1,0,20,0,-20
1458,0,0,21,0,-21
1459,1,0,75,0,-75
1460,1,1,379,3733,3354
1461,1,1,441,1287,846
1462,1,0,33,0,-33
1463,0,0,23,0,-23
1464,0,0,14,0,-14
1465,1,1,1721,1690,-31
1466,1,0,4,0,-4
1467,1,1,1018,1731,713
1468,0,0,61,0,-61
1469,1,1,486,1650,1164
1470,1,1,724,2643,1919
1471,1,1,633,1602,969
1472,1,1,1008,1552,544
1473,0,0,36,0,-36
1474,1,1,198,1408,1210
1475,0,0,44,0,-44
1476,1,1,357,1359,1002
1477,1,0,9,0,-9
1478,1,0,7,0,-7
1479,1,1,165,1397,1232
1480,1,1,291,1343,1052
1481,1,0,31,0,-31
1482,1,1,345,1363,1018
1483,1,0,16,0,-16
1484,0,0,38,0,-38
1485,0,0,40,0,-40
1486,1,0,26,0,-26
1487,1,1,244,1636,1392
1488,0,0,8,0,-8
1489,1,0,53,0,-53
1490,1,0,30,0,-30
1491,1,0,34,0,-34
1492,0,0,92,0,-92
1493,1,1,297,1222,925
1494,0,0,160,0,-160
1495,1,1,539,1590,1051
1496,1,0,131,0,-131
1497,0,0,30,0,-30
1498,0,0,43,0,-43
1499,0,0,5,0,-5
1500,0,0,84,0,-84
1501,0,0,31,0,-31
1502,1,0,14,0,-14
1503,1,0,7,0,-7
1504,1,0,33,0,-33
1505,1,1,1697,1875,178
1506,0,0,9,0,-9
1507,0,0,92,0,-92
1508,1,1,29,2370,2341
1509,0,0,47,0,-47
1510,1,1,522,1430,908
1511,1,1,710,1293,583
1512,1,0,10,0,-10
1513,1,0,24,0,-24
1514,1,0,20,0,-20
1515,0,0,2,0,-2
1516,0,0,26,0,-26
1517,1,1,833,1216,383
1518,0,0,71,0,-71
1519,1,0,22,0,-22
1520,1,1,830,1449,619
1521,1,0,42,0,-42
1522,1,0,84,0,-84
1523,0,0,44,0,-44
1524,1,1,2531,1705,-826
1525,0,0,38,0,-38
1526,0,0,97,0,-97
1527,0,0,123,0,-123
1528,0,0,39,0,-39
1529,0,0,12,0,-12
1530,1,1,1410,1639,229
1531,0,0,16,0,-16
1532,1,1,881,1280,399
1533,0,0,94,0,-94
1534,0,0,105,0,-105
1535,1,0,21,0,-21
1536,1,1,150,1256,1106
1537,1,0,47,0,-47
1538,1,0,10,0,-10
1539,1,1,714,1229,515
1540,1,1,830,2272,1442
1541,1,0,79,0,-79
1542,1,0,103,0,-103
1543,0,0,1,0,-1
1544,0,0,43,0,-43
1545,0,0,57,0,-57
1546,1,1,15,2143,2128
1547,1,0,5,0,-5
1548,0,0,26,0,-26
1549,0,0,19,0,-19
1550,1,1,116,1218,1102
1551,1,0,13,0,-13
1552,1,1,860,2518,1658
1553,0,0,133,0,-133
1554,1,0,79,0,-79
1555,0,0,36,0,-36
1556,0,0,86,0,-86
1557,1,1,260,1322,1062
1558,1,1,462,1467,1005
1559,1,0,99,0,-99
1560,1,1,223,1502,1279
1561,1,0,8,0,-8
1562,0,0,19,0,-19
1563,1,1,688,1265,577
1564,0,0,28,0,-28
1565,1,0,30,0,-30
1566,1,1,1272,1431,159
1567,0,0,34,0,-34
1568,1,1,15,1230,1215
1569,1,1,346,1254,908
1570,1,0,209,0,-209
1571,1,1,606,1383,777
1572,1,1,509,1314,805
1573,1,0,14,0,-14
1574,1,0,75,0,-75
1575,1,0,21,0,-21
1576,1,0,38,0,-38
1577,0,0,37,0,-37
1578,0,0,33,0,-33
1579,1,0,105,0,-105
1580,1,0,35,0,-35
1581,1,1,94,1350,1256
1582,0,0,79,0,-79
1583,0,0,166,0,-166
1584,1,1,978,1778,800
1585,1,0,54,0,-54
1586,1,1,1027,1280,253
1587,1,0,22,0,-22
1588,0,0,5,0,-5
1589,1,1,939,1449,510
1590,0,0,159,0,-159
1591,0,0,55,0,-55
1592,1,1,1043,1278,235
1593,1,1,194,1301,1107
1594,1,0,70,0,-70
1595,1,1,1842,1349,-493
1596,1,0,23,0,-23
1597,0,0,74,0,-74
1598,1,1,96,1217,1121
1599,1,0,5,0,-5
1600,1,1,211,1849,1638
1601,1,0,101,0,-101
1602,0,0,13,0,-13
1603,1,1,228,1472,1244
1604,1,1,784,1894,1110
1605,0,0,22,0,-22
1606,1,0,34,0,-34
1607,0,0,140,0,-140
1608,1,1,353,1215,862
1609,1,1,835,1319,484
1610,1,0,25,0,-25
1611,0,0,33,0,-33
1612,1,1,157,2512,2355
1613,1,1,1048,2332,1284
1614,1,0,77,0,-77
1615,0,0,64,0,-64
1616,1,1,483,1474,991
1617,1,1,124,1232,1108
1618,1,0,94,0,-94
1619,0,0,134,0,-134
1620,1,1,117,1230,1113
1621,0,0,34,0,-34
1622,0,0,20,0,-20
1623,0,0,5,0,-5
1624,1,0,5,0,-5
1625,1,0,57,0,-57
1626,0,0,62,0,-62
1627,0,0,305,0,-305
1628,0,0,2,0,-2
1629,0,0,6,0,-6
1630,1,0,4,0,-4
1631,0,0,28,0,-28
1632,1,1,573,1433,860
1633,1,0,28,0,-28
1634,0,0,103,0,-103
1635,1,0,17,0,-17
1636,1,0,5,0,-5
1637,0,0,51,0,-51
1638,0,0,86,0,-86
1639,1,0,75,0,-75
1640,1,1,634,1306,672
1641,0,0,83,0,-83
1642,1,1,205,1704,1499
1643,1,0,8,0,-8
1644,1,0,44,0,-44
1645,1,1,724,1514,790
1646,0,0,64,0,-64
1647,1,0,202,0,-202
1648,1,0,38,0,-38
1649,1,1,251,1479,1228
1650,1,0,22,0,-22
1651,0,0,59,0,-59
1652,1,0,143,0,-143
1653,1,1,685,1224,539
1654,0,0,42,0,-42
1655,1,1,512,1342,830
1656,0,0,29,0,-29
1657,0,0,78,0,-78
1658,1,0,12,0,-12
1659,0,0,4,0,-4
1660,1,1,290,1341,1051
1661,1,1,2775,1208,-1567
1662,0,0,52,0,-52
1663,0,0,24,0,-24
1664,0,0,38,0,-38
1665,0,0,37,0,-37
1666,0,0,57,0,-57
1667,1,1,282,1588,1306
1668,0,0,69,0,-69
1669,0,0,24,0,-24
1670,1,0,9,0,-9
1671,1,1,134,1212,1078
1672,1,1,210,2975,2765
1673,0,0,23,0,-23
1674,1,0,58,0,-58
1675,0,0,55,0,-55
1676,1,1,649,1619,970
1677,0,0,90,0,-90
1678,0,0,54,0,-54
1679,1,0,96,0,-96
1680,1,0,33,0,-33
1681,0,0,12,0,-12
1682,1,1,1074,1301,227
1683,1,1,174,1902,1728
1684,1,0,90,0,-90
1685,1,0,15,0,-15
1686,0,0,16,0,-16
1687,1,0,54,0,-54
1688,1,0,143,0,-143
1689,0,0,123,0,-123
1690,0,0,13,0,-13
1691,1,0,60,0,-60
1692,1,1,646,1696,1050
1693,1,1,1106,1254,148
1694,1,1,374,1589,1215
1695,1,0,35,0,-35
1696,1,1,837,1235,398
1697,1,0,60,0,-60
1698,0,0,55,0,-55
1699,1,0,40,0,-40
1700,0,0,15,0,-15
1701,0,0,254,0,-254
1702,1,1,482,1449,967
1703,0,0,8,0,-8
1704,1,0,23,0,-23
1705,0,0,59,0,-59
1706,1,0,20,0,-20
1707,0,0,19,0,-19
1708,1,0,68,0,-68
1709,0,0,36,0,-36
1710,1,0,15,0,-15
1711,1,0,150,0,-150
1712,1,1,235,1339,1104
1713,1,1,323,1319,996
1714,0,0,7,0,-7
1715,1,1,76,1301,1225
1716,1,1,508,2082,1574
1717,0,0,36,0,-36
1718,0,0,24,0,-24
1719,1,1,88,1314,1226
1720,0,0,5,0,-5
1721,0,0,20,0,-20
1722,1,1,460,2450,1990
1723,1,1,577,1209,632
1724,0,0,42,0,-42
1725,1,0,21,0,-21
1726,1,1,601,1232,631
1727,1,0,17,0,-17
1728,1,1,367,1298,931
1729,1,0,0,0,0
1730,1,0,92,0,-92
1731,1,0,93,0,-93
1732,1,1,1265,1225,-40
1733,1,0,15,0,-15
1734,0,0,36,0,-36
1735,1,0,65,0,-65
1736,0,0,95,0,-95
1737,1,1,202,1215,1013
1738,1,1,39,2467,2428
1739,1,0,8,0,-8
1740,0,0,32,0,-32
1741,1,0,10,0,-10
1742,0,0,73,0,-73
1743,0,0,56,0,-56
1744,0,0,24,0,-24
1745,0,0,28,0,-28
1746,0,0,226,0,-226
1747,0,0,36,0,-36
1748,1,1,901,1307,406
1749,1,0,112,0,-112
1750,1,0,39,0,-39
1751,1,0,72,0,-72
1752,0,0,62,0,-62
1753,0,0,29,0,-29
1754,1,0,61,0,-61
1755,0,0,34,0,-34
1756,1,0,42,0,-42
1757,1,1,107,1873,1766
1758,0,0,9,0,-9
1759,0,0,11,0,-11
1760,1,0,46,0,-46
1761,1,1,28,1803,1775
1762,0,0,54,0,-54
1763,0,0,40,0,-40
1764,1,1,393,1237,844
1765,1,1,26,1357,1331
1766,1,1,633,1386,753
1767,1,1,206,1468,1262
1768,1,1,1502,1361,-141
1769,1,0,66,0,-66
1770,1,0,133,0,-133
1771,1,0,1,0,-1
1772,0,0,129,0,-129
1773,1,1,394,1203,809
1774,1,1,1250,1397,147
1775,0,0,127,0,-127
1776,0,0,20,0,-20
1777,1,1,794,1635,841
1778,1,0,113,0,-113
1779,1,0,4,0,-4
1780,1,1,1079,1549,470
1781,0,0,23,0,-23
1782,0,0,58,0,-58
1783,1,0,35,0,-35
1784,0,0,63,0,-63
1785,1,0,17,0,-17
1786,1,1,192,1306,1114
1787,1,1,219,1252,1033
1788,1,1,314,1351,1037
1789,1,1,72,4039,3967
1790,0,0,38,0,-38
1791,1,0,50,0,-50
1792,1,0,22,0,-22
1793,0,0,123,0,-123
1794,0,0,8,0,-8
1795,1,0,17,0,-17
1796,0,0,3,0,-3
1797,1,1,694,1233,539
1798,1,0,96,0,-96
1799,1,1,256,1392,1136
1800,1,1,186,1290,1104
1801,1,0,53,0,-53
1802,1,0,87,0,-87
1803,1,0,22,0,-22
1804,1,0,31,0,-31
1805,0,0,54,0,-54
1806,1,0,27,0,-27
1807,1,1,752,1434,682
1808,1,0,7,0,-7
1809,0,0,27,0,-27
1810,1,1,150,1373,1223
1811,0,0,111,0,-111
1812,0,0,92,0,-92
1813,1,1,330,1485,1155
1814,1,1,625,1598,973
1815,0,0,12,0,-12
1816,0,0,155,0,-155
1817,1,1,576,1728,1152
1818,0,0,27,0,-27
1819,1,0,23,0,-23
1820,0,0,40,0,-40
1821,1,1,89,1593,1504
1822,0,0,52,0,-52
1823,0,0,108,0,-108
1824,0,0,60,0,-60
1825,0,0,115,0,-115
1826,1,1,184,1368,1184
1827,0,0,43,0,-43
1828,0,0,38,0,-38
1829,0,0,61,0,-61
1830,1,0,2,0,-2
1831,0,0,0,0,0
1832,0,0,22,0,-22
1833,1,1,32,2478,2446
1834,1,0,21,0,-21
1835,1,1,569,1608,1039
1836,1,1,1971,1597,-374
1837,1,1,455,1557,1102
1838,1,1,236,1314,1078
1839,0,0,34,0,-34
1840,0,0,36,0,-36
1841,0,0,257,0,-257
1842,0,0,0,0,0
1843,1,0,106,0,-106
1844,1,1,193,1352,1159
1845,1,1,848,1362,514
1846,0,0,47,0,-47
1847,0,0,0,0,0
1848,1,1,357,3259,2902
1849,1,1,175,1264,1089
1850,1,1,69,3265,3196
1851,0,0,24,0,-24
1852,1,1,145,8256,8111
1853,0,0,20,0,-20
1854,1,1,889,2796,1907
1855,1,0,84,0,-84
1856,0,0,100,0,-100
1857,1,0,21,0,-21
1858,1,1,226,1215,989
1859,1,1,355,1303,948
1860,1,0,34,0,-34
1861,0,0,38,0,-38
1862,0,0,86,0,-86
1863,0,0,62,0,-62
1864,0,0,14,0,-14
1865,1,1,226,1565,1339
1866,1,0,20,0,-20
1867,1,0,110,0,-110
1868,1,0,15,0,-15
1869,1,0,0,0,0
1870,0,0,11,0,-11
1871,0,0,16,0,-16
1872,1,0,36,0,-36
1873,1,0,23,0,-23
1874,0,0,109,0,-109
1875,1,0,48,0,-48
1876,1,1,674,2269,1595
1877,1,1,60,1212,1152
1878,1,1,32,1964,1932
1879,1,0,36,0,-36
1880,1,0,82,0,-82
1881,1,1,240,1898,1658
1882,1,0,0,0,0
1883,0,0,46,0,-46
1884,1,0,33,0,-33
1885,0,0,3,0,-3
1886,1,1,961,1366,405
1887,0,0,28,0,-28
1888,1,1,624,1264,640
1889,1,0,50,0,-50
1890,1,0,96,0,-96
1891,1,0,97,0,-97
1892,1,1,32,2396,2364
1893,1,1,183,1530,1347
1894,1,0,13,0,-13
1895,0,0,23,0,-23
1896,1,0,5,0,-5
1897,1,0,26,0,-26
1898,1,1,889,1419,530
1899,1,1,641,1290,649
1900,0,0,87,0,-87
1901,0,0,15,0,-15
1902,1,0,70,0,-70
1903,1,0,57,0,-57
1904,1,0,77,0,-77
1905,1,1,1344,1201,-143
1906,1,0,59,0,-59
1907,0,0,17,0,-17
1908,0,0,70,0,-70
1909,0,0,6,0,-6
1910,0,0,9,0,-9
1911,1,0,45,0,-45
1912,1,0,6,0,-6
1913,1,1,110,1571,1461
1914,0,0,38,0,-38
1915,1,0,14,0,-14
1916,1,1,237,1348,1111
1917,1,0,30,0,-30
1918,1,1,2037,1313,-724
1919,0,0,83,0,-83
1920,0,0,1,0,-1
1921,1,1,41,1401,1360
1922,0,0,49,0,-49
1923,0,0,98,0,-98
1924,1,1,345,1671,1326
1925,0,0,1,0,-1
1926,0,0,101,0,-101
1927,0,0,135,0,-135
1928,1,0,21,0,-21
1929,1,1,267,1512,1245
1930,1,0,44,0,-44
1931,1,1,59,1342,1283
1932,1,1,650,1439,789
1933,0,0,27,0,-27
1934,1,0,84,0,-84
1935,1,0,4,0,-4
1936,1,1,355,1295,940
1937,1,1,1013,1200,187
1938,1,0,26,0,-26
1939,0,0,32,0,-32
1940,1,1,69,1266,1197
1941,0,0,390,0,-390
1942,1,0,46,0,-46
1943,1,0,9,0,-9
1944,0,0,30,0,-30
1945,1,0,47,0,-47
1946,0,0,131,0,-131
1947,0,0,4,0,-4
1948,1,1,168,1494,1326
1949,1,1,756,1335,579
1950,0,0,45,0,-45
1951,0,0,6,0,-6
1952,1,0,30,0,-30
1953,1,0,55,0,-55
1954,0,0,166,0,-166
1955,1,0,48,0,-48
1956,1,1,167,1472,1305
1957,1,1,184,1504,1320
1958,0,0,52,0,-52
1959,0,0,67,0,-67
1960,1,0,74,0,-74
1961,0,0,13,0,-13
1962,1,0,57,0,-57
1963,1,0,32,0,-32
1964,1,1,268,1276,1008
1965,1,1,187,1566,1379
1966,1,0,16,0,-16
1967,1,0,39,0,-39
1968,1,1,929,1290,361
1969,1,1,1299,1365,66
1970,0,0,161,0,-161
1971,1,0,110,0,-110
1972,0,0,22,0,-22
1973,1,1,193,1268,1075
1974,0,0,91,0,-91
1975,0,0,36,0,-36
1976,0,0,43,0,-43
1977,1,1,548,1367,819
1978,1,0,2,0,-2
1979,1,0,15,0,-15
1980,1,1,1165,1976,811
1981,1,0,3,0,-3
1982,1,1,295,1377,1082
1983,1,0,3,0,-3
1984,0,0,102,0,-102
1985,1,0,161,0,-161
1986,0,0,77,0,-77
1987,1,0,27,0,-27
1988,1,0,1,0,-1
1989,1,0,42,0,-42
1990,0,0,31,0,-31
1991,0,0,50,0,-50
1992,1,0,118,0,-118
1993,0,0,20,0,-20
1994,0,0,59,0,-59
1995,1,1,730,1672,942
1996,0,0,8,0,-8
1997,0,0,7,0,-7
1998,0,0,0,0,0
1999,1,1,147,1328,1181
2000,1,0,62,0,-62
2001,1,1,535,1409,874
2002,0,0,6,0,-6
2003,1,1,644,1472,828
2004,1,1,646,1582,936
2005,1,1,1961,1419,-542
2006,0,0,56,0,-56
2007,1,0,2,0,-2
2008,0,0,3,0,-3
2009,0,0,38,0,-38
2010,1,0,13,0,-13
2011,0,0,83,0,-83
2012,0,0,13,0,-13
2013,1,1,295,2047,1752
2014,0,0,45,0,-45
2015,1,1,389,1887,1498
2016,0,0,14,0,-14
2017,0,0,4,0,-4
2018,1,1,298,1663,1365
2019,1,0,82,0,-82
2020,1,1,901,1471,570
2021,1,1,683,1218,535
2022,1,1,133,1672,1539
2023,0,0,46,0,-46
2024,0,0,52,0,-52
2025,1,0,42,0,-42
2026,1,1,86,1488,1402
2027,1,0,37,0,-37
2028,1,1,24,1281,1257
2029,1,1,59,1660,1601
2030,1,1,1061,2071,1010
2031,0,0,60,0,-60
2032,1,1,1121,1941,820
2033,0,0,70,0,-70
2034,1,1,772,1256,484
2035,1,0,2,0,-2
2036,1,1,103,1212,1109
2037,0,0,98,0,-98
2038,1,1,522,1916,1394
2039,1,1,917,1593,676
2040,0,0,3,0,-3
2041,0,0,9,0,-9
2042,1,1,117,1935,1818
2043,0,0,50,0,-50
2044,1,0,68,0,-68
2045,0,0,46,0,-46
2046,0,0,1,0,-1
2047,0,0,0,0,0
2048,1,0,207,0,-207
2049,0,0,100,0,-100
2050,1,0,10,0,-10
2051,1,0,78,0,-78
2052,1,0,30,0,-30
2053,1,0,276,0,-276
2054,1,1,675,1700,1025
2055,1,1,765,1234,469
2056,0,0,18,0,-18
2057,0,0,17,0,-17
2058,1,1,144,1328,1184
2059,1,0,48,0,-48
2060,0,0,51,0,-51
2061,1,1,586,2589,2003
2062,1,1,258,2907,2649
2063,0,0,2,0,-2
2064,0,0,10,0,-10
2065,0,0,52,0,-52
2066,0,0,91,0,-91
2067,1,1,126,1671,1545
2068,0,0,10,0,-10
2069,1,0,33,0,-33
2070,1,1,1501,1682,181
2071,1,1,349,1742,1393
2072,1,0,5,0,-5
2073,0,0,51,0,-51
2074,0,0,100,0,-100
2075,0,0,30,0,-30
2076,1,0,3,0,-3
2077,0,0,26,0,-26
2078,0,0,20,0,-20
2079,1,0,18,0,-18
2080,1,0,11,0,-11
2081,0,0,49,0,-49
2082,1,0,83,0,-83
2083,1,0,193,0,-193
2084,1,1,1811,1680,-131
2085,1,0,48,0,-48
2086,1,0,23,0,-23
2087,0,0,17,0,-17
2088,0,0,46,0,-46
2089,1,0,161,0,-161
2090,1,1,121,1215,1094
2091,1,1,154,1966,1812
2092,0,0,84,0,-84
2093,0,0,5,0,-5
2094,1,0,21,0,-21
2095,1,0,36,0,-36
2096,0,0,5,0,-5
2097,1,0,4,0,-4
2098,1,1,292,2148,1856
2099,0,0,18,0,-18
2100,1,1,1500,1536,36
2101,1,1,904,1414,510
2102,1,1,742,4197,3455
2103,0,0,89,0,-89
2104,0,0,98,0,-98
2105,0,0,76,0,-76
2106,1,0,19,0,-19
2107,1,1,273,5572,5299
2108,0,0,36,0,-36
2109,0,0,42,0,-42
2110,1,0,41,0,-41
2111,1,1,119,2081,1962
2112,1,0,20,0,-20
2113,1,0,35,0,-35
2114,1,0,50,0,-50
2115,1,1,480,1299,819
2116,1,0,85,0,-85
2117,1,1,176,3337,3161
2118,0,0,60,0,-60
2119,1,0,23,0,-23
2120,0,0,21,0,-21
2121,0,0,37,0,-37
2122,1,0,54,0,-54
2123,0,0,63,0,-63
2124,0,0,16,0,-16
2125,0,0,79,0,-79
2126,0,0,76,0,-76
2127,1,1,53,1451,1398
2128,0,0,3,0,-3
2129,1,0,7,0,-7
2130,1,1,801,1923,1122
2131,1,1,338,1624,1286
2132,1,0,66,0,-66
2133,1,0,9,0,-9
2134,1,0,16,0,-16
2135,1,1,432,1526,1094
2136,1,1,556,1703,1147
2137,1,1,85,1232,1147
2138,1,0,13,0,-13
2139,1,1,265,1703,1438
2140,0,0,208,0,-208
2141,0,0,33,0,-33
2142,1,1,265,1263,998
2143,1,0,129,0,-129
2144,1,0,86,0,-86
2145,0,0,49,0,-49
2146,1,0,67,0,-67
2147,1,0,120,0,-120
2148,1,1,451,1286,835
2149,1,0,19,0,-19
2150,0,0,15,0,-15
2151,1,0,9,0,-9
2152,0,0,27,0,-27
2153,0,0,10,0,-10
2154,0,0,3,0,-3
2155,0,0,20,0,-20
2156,1,1,640,1349,709
2157,0,0,79,0,-79
2158,0,0,24,0,-24
2159,0,0,1,0,-1
2160,1,1,132,3112,2980
2161,0,0,30,0,-30
2162,1,1,651,1620,969
2163,0,0,36,0,-36
2164,1,1,200,3043,2843
2165,0,0,93,0,-93
2166,1,0,1,0,-1
2167,1,0,11,0,-11
2168,1,1,197,1214,1017
2169,0,0,44,0,-44
2170,0,0,28,0,-28
2171,1,1,92,1579,1487
2172,0,0,67,0,-67
2173,1,0,33,0,-33
2174,0,0,19,0,-19
2175,1,0,35,0,-35
2176,1,0,0,0,0
2177,1,1,284,1586,1302
2178,1,0,196,0,-196
2179,1,0,209,0,-209
2180,1,1,763,1425,662
2181,1,0,25,0,-25
2182,1,0,110,0,-110
2183,1,0,74,0,-74
2184,1,1,237,1295,1058
2185,1,0,109,0,-109
2186,1,0,104,0,-104
2187,0,0,5,0,-5
2188,1,1,267,2149,1882
2189,1,0,29,0,-29
2190,0,0,182,0,-182
2191,0,0,12,0,-12
2192,1,0,13,0,-13
2193,1,0,54,0,-54
2194,1,0,15,0,-15
2195,1,0,14,0,-14
2196,1,0,42,0,-42
2197,1,0,9,0,-9
2198,1,1,510,1604,1094
2199,0,0,195,0,-195
2200,1,0,72,0,-72
2201,0,0,31,0,-31
2202,0,0,22,0,-22
2203,1,0,27,0,-27
2204,1,1,864,2107,1243
2205,1,0,45,0,-45
2206,1,1,6,1870,1864
2207,1,0,4,0,-4
2208,1,0,22,0,-22
2209,0,0,81,0,-81
2210,0,0,21,0,-21
2211,0,0,53,0,-53
2212,0,0,38,0,-38
2213,1,0,103,0,-103
2214,1,0,31,0,-31
2215,1,1,1198,1358,160
2216,0,0,117,0,-117
2217,1,1,164,1317,1153
2218,1,0,29,0,-29
2219,1,1,108,1346,1238
2220,0,0,18,0,-18
2221,0,0,1,0,-1
2222,0,0,54,0,-54
2223,1,1,1191,1280,89
2224,0,0,27,0,-27
2225,1,0,3,0,-3
2226,1,1,1238,1321,83
2227,0,0,25,0,-25
2228,1,0,74,0,-74
2229,1,1,247,2341,2094
2230,1,0,38,0,-38
2231,0,0,27,0,-27
2232,0,0,42,0,-42
2233,1,0,96,0,-96
2234,0,0,57,0,-57
2235,1,0,64,0,-64
2236,0,0,14,0,-14
2237,1,0,50,0,-50
2238,0,0,23,0,-23
2239,0,0,9,0,-9
2240,0,0,76,0,-76
2241,0,0,36,0,-36
2242,0,0,333,0,-333
2243,1,1,644,1307,663
2244,0,0,6,0,-6
2245,0,0,66,0,-66
2246,1,1,344,2555,2211
2247,0,0,72,0,-72
2248,1,0,5,0,-5
2249,1,0,157,0,-157
2250,1,1,6,1777,1771
2251,1,0,38,0,-38
2252,1,0,154,0,-154
2253,1,1,275,1438,1163
2254,1,1,85,1685,1600
2255,1,1,695,2236,1541
2256,1,1,256,1217,961
2257,0,0,84,0,-84
2258,0,0,29,0,-29
2259,1,0,31,0,-31
2260,1,1,39,1268,1229
2261,0,0,4,0,-4
2262,0,0,22,0,-22
2263,1,0,72,0,-72
2264,1,1,33,1466,1433
2265,1,1,337,1313,976
2266,1,0,7,0,-7
2267,1,0,18,0,-18
2268,0,0,76,0,-76
2269,1,0,36,0,-36
2270,1,0,70,0,-70
2271,0,0,28,0,-28
2272,0,0,56,0,-56
2273,1,0,110,0,-110
2274,0,0,87,0,-87
2275,1,0,12,0,-12
2276,1,1,276,1482,1206
2277,1,1,462,1203,741
2278,0,0,4,0,-4
2279,0,0,88,0,-88
2280,1,0,93,0,-93
2281,1,0,55,0,-55
2282,0,0,14,0,-14
2283,0,0,7,0,-7
2284,0,0,106,0,-106
2285,1,1,332,1328,996
2286,1,1,320,1369,1049
2287,1,0,112,0,-112
2288,1,0,20,0,-20
2289,1,0,34,0,-34
2290,0,0,155,0,-155
2291,1,0,126,0,-126
2292,0,0,72,0,-72
2293,1,1,116,1334,1218
2294,1,1,1098,1962,864
2295,1,0,33,0,-33
2296,0,0,94,0,-94
2297,1,1,1152,1279,127
2298,0,0,39,0,-39
2299,1,1,106,1247,1141
2300,0,0,95,0,-95
2301,1,0,18,0,-18
2302,1,0,56,0,-56
2303,1,1,169,2593,2424
2304,1,1,217,1324,1107
2305,0,0,2,0,-2
2306,1,0,67,0,-67
2307,1,1,172,1560,1388
2308,1,0,10,0,-10
2309,0,0,34,0,-34
2310,1,0,11,0,-11
2311,1,1,496,1351,855
2312,0,0,4,0,-4
2313,1,1,137,1221,1084
2314,1,1,1079,1952,873
2315,1,1,1209,1301,92
2316,1,0,12,0,-12
2317,1,1,371,2115,1744
2318,0,0,149,0,-149
2319,1,1,1149,1748,599
2320,1,0,0,0,0
2321,1,0,183,0,-183
2322,1,0,81,0,-81
2323,0,0,11,0,-11
2324,0,0,34,0,-34
2325,1,0,52,0,-52
2326,1,1,1098,1325,227
2327,1,0,6,0,-6
2328,0,0,16,0,-16
2329,1,1,845,1208,363
2330,0,0,0,0,0
2331,1,0,26,0,-26
2332,1,1,940,1342,402
2333,1,0,15,0,-15
2334,0,0,36,0,-36
2335,0,0,65,0,-65
2336,1,0,7,0,-7
2337,0,0,30,0,-30
2338,0,0,16,0,-16
2339,1,0,10,0,-10
2340,0,0,16,0,-16
2341,1,0,4,0,-4
2342,1,0,14,0,-14
2343,1,0,13,0,-13
2344,0,0,200,0,-200
2345,1,0,86,0,-86
2346,1,0,73,0,-73
2347,0,0,16,0,-16
2348,1,1,731,1469,738
2349,1,0,96,0,-96
2350,1,1,853,1241,388
2351,1,0,81,0,-81
2352,1,1,99,1230,1131
2353,0,0,65,0,-65
2354,1,1,1524,1209,-315
2355,0,0,15,0,-15
2356,1,1,419,1206,787
2357,1,0,63,0,-63
2358,0,0,1,0,-1
2359,1,1,241,1605,1364
2360,0,0,13,0,-13
2361,0,0,9,0,-9
2362,1,1,137,1984,1847
2363,0,0,242,0,-242
2364,0,0,14,0,-14
2365,1,1,523,1318,795
2366,0,0,102,0,-102
2367,0,0,100,0,-100
2368,0,0,26,0,-26
2369,0,0,77,0,-77
2370,0,0,141,0,-141
2371,1,0,46,0,-46
2372,0,0,34,0,-34
2373,0,0,5,0,-5
2374,0,0,6,0,-6
2375,0,0,4,0,-4
2376,1,1,102,1321,1219
2377,0,0,11,0,-11
2378,1,1,287,1316,1029
2379,1,0,12,0,-12
2380,0,0,17,0,-17
2381,1,1,17,1241,1224
2382,0,0,19,0,-19
2383,1,1,1958,1201,-757
2384,0,0,104,0,-104
2385,1,1,365,1707,1342
2386,1,1,941,1670,729
2387,1,0,32,0,-32
2388,1,1,715,1286,571
2389,0,0,28,0,-28
2390,0,0,10,0,-10
2391,1,1,864,2926,2062
2392,1,0,22,0,-22
2393,1,1,597,1982,1385
2394,1,1,1006,1368,362
2395,1,0,83,0,-83
2396,1,0,20,0,-20
2397,1,1,330,1275,945
2398,1,1,90,2080,1990
2399,1,1,174,1303,1129
2400,1,0,34,0,-34
2401,0,0,19,0,-19
2402,0,0,79,0,-79
2403,1,0,18,0,-18
2404,1,0,4,0,-4
2405,0,0,45,0,-45
2406,0,0,84,0,-84
2407,0,0,21,0,-21
2408,1,0,70,0,-70
2409,1,0,15,0,-15
2410,1,0,22,0,-22
2411,1,0,0,0,0
2412,0,0,50,0,-50
2413,0,0,53,0,-53
2414,0,0,3,0,-3
2415,0,0,102,0,-102
2416,0,0,43,0,-43
2417,1,1,349,2312,1963
2418,1,1,78,2192,2114
2419,0,0,35,0,-35
2420,1,0,49,0,-49
2421,1,0,9,0,-9
2422,0,0,22,0,-22
2423,1,0,180,0,-180
2424,1,0,62,0,-62
2425,0,0,2,0,-2
2426,1,1,397,1936,1539
2427,1,1,265,1724,1459
2428,1,0,121,0,-121
2429,0,0,108,0,-108
2430,0,0,8,0,-8
2431,1,0,38,0,-38
2432,0,0,32,0,-32
2433,1,0,59,0,-59
2434,1,0,22,0,-22
2435,1,0,148,0,-148
2436,1,1,966,1967,1001
2437,1,0,45,0,-45
2438,0,0,96,0,-96
2439,1,0,11,0,-11
2440,0,0,7,0,-7
2441,1,1,728,1373,645
2442,1,0,14,0,-14
2443,0,0,83,0,-83
2444,0,0,1,0,-1
2445,1,0,40,0,-40
2446,1,0,3,0,-3
2447,0,0,35,0,-35
2448,1,1,971,1841,870
2449,1,1,237,1465,1228
2450,1,1,145,1529,1384
2451,0,0,36,0,-36
2452,0,0,3,0,-3
2453,1,1,1122,1621,499
2454,0,0,2,0,-2
2455,1,1,1007,2514,1507
2456,1,1,285,1465,1180
2457,1,0,29,0,-29
2458,1,1,182,1346,1164
2459,0,0,71,0,-71
2460,0,0,2,0,-2
2461,0,0,17,0,-17
2462,1,0,63,0,-63
2463,1,0,69,0,-69
2464,1,0,34,0,-34
2465,1,1,936,1345,409
2466,1,1,1217,1225,8
2467,0,0,1,0,-1
2468,1,1,650,1613,963
2469,1,0,6,0,-6
2470,1,1,1334,1381,47
2471,1,1,673,1253,580
2472,0,0,117,0,-117
2473,1,1,897,1310,413
2474,1,1,956,1579,623
2475,1,0,34,0,-34
2476,0,0,70,0,-70
2477,1,1,237,1775,1538
2478,1,1,1091,2231,1140
2479,1,0,54,0,-54
2480,0,0,9,0,-9
2481,0,0,47,0,-47
2482,0,0,11,0,-11
2483,0,0,41,0,-41
2484,1,1,915,1476,561
2485,1,1,125,1542,1417
2486,1,1,1193,1337,144
2487,0,0,11,0,-11
2488,0,0,21,0,-21
2489,0,0,88,0,-88
2490,0,0,51,0,-51
2491,1,1,350,2150,1800
2492,0,0,86,0,-86
2493,1,0,30,0,-30
2494,1,1,399,1244,845
2495,1,0,5,0,-5
2496,1,0,15,0,-15
2497,1,0,25,0,-25
2498,0,0,70,0,-70
2499,0,0,0,0,0
2500,0,0,52,0,-52
2501,1,1,659,1205,546
2502,1,1,163,1248,1085
2503,0,0,18,0,-18
2504,1,1,86,1610,1524
2505,0,0,20,0,-20
2506,1,0,43,0,-43
2507,0,0,103,0,-103
2508,1,0,12,0,-12
2509,1,1,229,1320,1091
2510,1,0,57,0,-57
2511,1,0,63,0,-63
2512,1,1,411,2946,2535
2513,0,0,12,0,-12
2514,1,0,50,0,-50
2515,0,0,19,0,-19
2516,1,0,30,0,-30
2517,0,0,79,0,-79
2518,1,0,53,0,-53
2519,0,0,1,0,-1
2520,0,0,47,0,-47
2521,1,1,363,1214,851
2522,1,1,364,1420,1056
2523,1,1,118,1301,1183
2524,1,1,465,1401,936
2525,1,1,779,3611,2832
2526,0,0,11,0,-11
2527,0,0,47,0,-47
2528,1,0,41,0,-41
2529,0,0,190,0,-190
2530,0,0,31,0,-31
2531,1,1,608,1704,1096
2532,0,0,0,0,0
2533,1,1,447,1281,834
2534,1,1,372,1409,1037
2535,1,0,31,0,-31
2536,1,1,42,1277,1235
2537,1,1,593,1319,726
2538,1,0,45,0,-45
2539,0,0,62,0,-62
2540,1,0,148,0,-148
2541,1,0,32,0,-32
2542,0,0,50,0,-50
2543,1,1,841,1358,517
2544,0,0,4,0,-4
2545,0,0,1,0,-1
2546,1,1,405,1356,951
2547,1,1,771,1216,445
2548,0,0,17,0,-17
2549,1,1,187,1611,1424
2550,0,0,22,0,-22
2551,0,0,2,0,-2
2552,1,0,14,0,-14
2553,1,0,74,0,-74
2554,0,0,35,0,-35
2555,0,0,3,0,-3
2556,0,0,5,0,-5
2557,1,0,11,0,-11
2558,1,1,395,1969,1574
2559,0,0,19,0,-19
2560,1,0,112,0,-112
2561,1,1,465,1531,1066
2562,0,0,143,0,-143
2563,1,1,227,1229,1002
2564,1,0,114,0,-114
2565,0,0,30,0,-30
2566,0,0,89,0,-89
2567,1,0,50,0,-50
2568,0,0,55,0,-55
2569,1,0,7,0,-7
2570,1,0,140,0,-140
2571,0,0,149,0,-149
2572,0,0,137,0,-137
2573,1,1,1969,1701,-268
2574,0,0,34,0,-34
2575,0,0,99,0,-99
2576,1,1,1198,1429,231
2577,1,0,7,0,-7
2578,1,0,46,0,-46
2579,1,0,16,0,-16
2580,1,0,29,0,-29
2581,1,1,6,1451,1445
2582,0,0,23,0,-23
2583,1,1,807,1891,1084
2584,1,0,17,0,-17
2585,0,0,1,0,-1
2586,1,0,195,0,-195
2587,0,0,65,0,-65
2588,0,0,110,0,-110
2589,0,0,76,0,-76
2590,0,0,4,0,-4
2591,0,0,70,0,-70
2592,1,1,351,1411,1060
2593,1,1,674,1489,815
2594,1,1,923,2198,1275
2595,0,0,8,0,-8
2596,0,0,38,0,-38
2597,0,0,106,0,-106
2598,0,0,44,0,-44
2599,1,0,9,0,-9
2600,0,0,5,0,-5
2601,1,0,55,0,-55
2602,0,0,2,0,-2
2603,1,1,2133,1354,-779
2604,1,0,7,0,-7
2605,1,1,162,1257,1095
2606,0,0,6,0,-6
2607,0,0,84,0,-84
2608,0,0,7,0,-7
2609,0,0,25,0,-25
2610,0,0,155,0,-155
2611,1,1,361,2081,1720
2612,1,1,491,1345,854
2613,1,1,70,2513,2443
2614,0,0,65,0,-65
2615,0,0,11,0,-11
2616,1,1,738,1234,496
2617,0,0,51,0,-51
2618,0,0,27,0,-27
2619,1,0,10,0,-10
2620,0,0,43,0,-43
2621,1,1,840,1436,596
2622,1,0,129,0,-129
2623,0,0,5,0,-5
2624,1,0,30,0,-30
2625,1,1,1963,1440,-523
2626,1,0,80,0,-80
2627,1,1,820,1486,666
2628,1,0,28,0,-28
2629,0,0,0,0,0
2630,0,0,118,0,-118
2631,1,0,6,0,-6
2632,1,1,892,1316,424
2633,0,0,47,0,-47
2634,0,0,19,0,-19
2635,0,0,1,0,-1
2636,0,0,138,0,-138
2637,1,1,720,1405,685
2638,1,1,313,1574,1261
2639,1,1,885,1204,319
2640,1,1,1373,1624,251
2641,1,1,557,1482,925
2642,1,0,23,0,-23
2643,1,1,90,1392,1302
2644,1,0,42,0,-42
2645,1,1,400,1565,1165
2646,0,0,137,0,-137
2647,1,1,160,1667,1507
2648,1,0,14,0,-14
2649,0,0,26,0,-26
2650,1,1,379,1915,1536
2651,0,0,46,0,-46
2652,1,1,273,1257,984
2653,1,0,17,0,-17
2654,0,0,0,0,0
2655,0,0,45,0,-45
2656,0,0,1,0,-1
2657,1,1,114,1284,1170
2658,0,0,49,0,-49
2659,1,0,50,0,-50
2660,0,0,144,0,-144
2661,1,0,113,0,-113
2662,0,0,145,0,-145
2663,0,0,40,0,-40
2664,1,0,9,0,-9
2665,0,0,118,0,-118
2666,1,0,11,0,-11
2667,1,0,102,0,-102
2668,1,0,77,0,-77
2669,1,0,35,0,-35
2670,0,0,110,0,-110
2671,0,0,26,0,-26
2672,1,1,241,1323,1082
2673,0,0,5,0,-5
2674,1,1,1500,1260,-240
2675,0,0,42,0,-42
2676,1,1,323,1423,1100
2677,1,1,504,1210,706
2678,1,0,122,0,-122
2679,1,1,139,1258,1119
2680,1,1,87,1204,1117
2681,1,0,13,0,-13
2682,1,1,306,1498,1192
2683,1,1,483,1612,1129
2684,1,0,48,0,-48
2685,1,1,619,1974,1355
2686,1,1,87,1344,1257
2687,0,0,23,0,-23
2688,1,0,61,0,-61
2689,1,0,12,0,-12
2690,1,1,270,1559,1289
2691,1,0,10,0,-10
2692,0,0,1,0,-1
2693,1,1,417,1294,877
2694,1,0,24,0,-24
2695,1,0,125,0,-125
2696,1,1,1249,1358,109
2697,1,1,841,1478,637
2698,0,0,34,0,-34
2699,1,1,1851,1427,-424
2700,1,1,154,1409,1255
2701,0,0,1,0,-1
2702,1,1,597,1425,828
2703,1,1,340,1435,1095
2704,1,0,5,0,-5
2705,1,1,198,1362,1164
2706,1,0,4,0,-4
2707,1,0,35,0,-35
2708,1,0,63,0,-63
2709,1,0,8,0,-8
2710,0,0,40,0,-40
2711,0,0,11,0,-11
2712,0,0,27,0,-27
2713,1,0,60,0,-60
2714,1,0,47,0,-47
2715,0,0,96,0,-96
2716,1,0,45,0,-45
2717,0,0,161,0,-161
2718,1,0,93,0,-93
2719,0,0,2,0,-2
2720,0,0,18,0,-18
2721,1,0,17,0,-17
2722,1,0,19,0,-19
2723,1,0,10,0,-10
2724,0,0,72,0,-72
2725,0,0,70,0,-70
2726,0,0,2,0,-2
2727,0,0,122,0,-122
2728,1,1,541,1518,977
2729,1,1,592,1348,756
2730,0,0,12,0,-12
2731,0,0,98,0,-98
2732,1,1,632,1200,568
2733,0,0,3,0,-3
2734,1,0,7,0,-7
2735,0,0,102,0,-102
2736,0,0,3,0,-3
2737,0,0,139,0,-139
2738,0,0,16,0,-16
2739,1,1,910,1318,408
2740,0,0,91,0,-91
2741,1,0,44,0,-44
2742,1,0,35,0,-35
2743,0,0,9,0,-9
2744,0,0,6,0,-6
2745,1,1,1370,1211,-159
2746,1,1,232,1609,1377
2747,0,0,3,0,-3
2748,1,0,46,0,-46
2749,1,0,15,0,-15
2750,0,0,42,0,-42
2751,0,0,6,0,-6
2752,1,1,400,1244,844
2753,1,0,67,0,-67
2754,1,1,1909,1761,-148
2755,1,1,443,2470,2027
2756,1,0,18,0,-18
2757,0,0,2,0,-2
2758,1,0,96,0,-96
2759,1,0,0,0,0
2760,1,0,37,0,-37
2761,1,0,57,0,-57
2762,1,1,898,1317,419
2763,0,0,74,0,-74
2764,0,0,55,0,-55
2765,0,0,28,0,-28
2766,1,0,16,0,-16
2767,1,1,339,1923,1584
2768,1,0,99,0,-99
2769,1,1,1022,1431,409
2770,1,1,395,1305,910
2771,1,0,68,0,-68
2772,1,0,46,0,-46
2773,1,0,73,0,-73
2774,0,0,4,0,-4
2775,0,0,6,0,-6
2776,1,0,69,0,-69
2777,1,0,0,0,0
2778,0,0,69,0,-69
2779,1,0,24,0,-24
2780,1,0,10,0,-10
2781,0,0,34,0,-34
2782,0,0,54,0,-54
2783,1,0,37,0,-37
2784,0,0,149,0,-149
2785,1,1,1066,2844,1778
2786,0,0,37,0,-37
2787,1,1,408,1387,979
2788,0,0,15,0,-15
2789,0,0,9,0,-9
2790,0,0,30,0,-30
2791,1,0,38,0,-38
2792,1,0,32,0,-32
2793,0,0,67,0,-67
2794,0,0,110,0,-110
2795,0,0,15,0,-15
2796,1,0,5,0,-5
2797,1,1,158,2024,1866
2798,0,0,37,0,-37
2799,0,0,36,0,-36
2800,0,0,95,0,-95
2801,0,0,92,0,-92
2802,0,0,46,0,-46
2803,1,0,20,0,-20
2804,0,0,104,0,-104
2805,1,0,31,0,-31
2806,1,1,103,1303,1200
2807,0,0,143,0,-143
2808,0,0,1,0,-1
2809,1,1,323,1234,911
2810,0,0,29,0,-29
2811,0,0,53,0,-53
2812,0,0,8,0,-8
2813,1,1,133,1685,1552
2814,1,0,112,0,-112
2815,1,1,1199,1638,439
2816,1,1,228,3158,2930
2817,1,0,5,0,-5
2818,1,1,1134,1547,413
2819,0,0,130,0,-130
2820,1,1,142,1210,1068
2821,1,0,4,0,-4
2822,0,0,5,0,-5
2823,1,1,972,1408,436
2824,1,1,405,2343,1938
2825,0,0,8,0,-8
2826,0,0,44,0,-44
2827,1,1,170,1562,1392
2828,1,1,343,1200,857
2829,1,0,50,0,-50
2830,1,0,139,0,-139
2831,1,1,830,1221,391
2832,1,0,85,0,-85
2833,0,0,76,0,-76
2834,0,0,39,0,-39
2835,1,0,19,0,-19
2836,1,0,42,0,-42
2837,0,0,74,0,-74
2838,1,1,182,1323,1141
2839,1,1,296,1446,1150
2840,1,1,342,1251,909
2841,1,1,370,1251,881
2842,0,0,29,0,-29
2843,1,1,432,1283,851
2844,1,0,3,0,-3
2845,0,0,23,0,-23
2846,1,0,180,0,-180
2847,1,1,904,1493,589
2848,1,0,20,0,-20
2849,1,0,103,0,-103
2850,0,0,10,0,-10
2851,1,1,1209,1808,599
2852,1,0,165,0,-165
2853,1,0,9,0,-9
2854,1,0,48,0,-48
2855,1,1,616,1211,595
2856,0,0,47,0,-47
2857,1,0,24,0,-24
2858,1,1,319,1528,1209
2859,1,0,33,0,-33
2860,0,0,103,0,-103
2861,0,0,34,0,-34
2862,1,1,265,1655,1390
2863,1,0,15,0,-15
2864,1,0,4,0,-4
2865,1,1,49,1238,1189
2866,1,0,17,0,-17
2867,0,0,25,0,-25
2868,1,1,348,1593,1245
2869,1,0,5,0,-5
2870,1,0,150,0,-150
2871,0,0,156,0,-156
2872,1,1,131,1638,1507
2873,1,0,12,0,-12
2874,1,0,52,0,-52
2875,1,1,691,1260,569
2876,0,0,83,0,-83
2877,0,0,57,0,-57
2878,0,0,1,0,-1
2879,0,0,53,0,-53
2880,1,0,3,0,-3
2881,0,0,113,0,-113
2882,0,0,5,0,-5
2883,0,0,83,0,-83
2884,0,0,52,0,-52
2885,0,0,2,0,-2
2886,1,1,1490,1298,-192
2887,1,1,340,1471,1131
2888,0,0,87,0,-87
2889,1,0,31,0,-31
2890,0,0,33,0,-33
2891,1,1,316,2127,1811
2892,1,0,51,0,-51
2893,0,0,31,0,-31
2894,1,1,455,1419,964
2895,0,0,25,0,-25
2896,1,0,30,0,-30
2897,1,1,1407,1608,201
2898,0,0,22,0,-22
2899,1,1,376,1900,1524
2900,0,0,55,0,-55
2901,1,0,124,0,-124
2902,1,0,150,0,-150
2903,1,0,75,0,-75
2904,1,0,5,0,-5
2905,1,1,37,1938,1901
2906,1,1,160,1216,1056
2907,1,1,574,1202,628
2908,0,0,93,0,-93
2909,1,1,1505,1233,-272
2910,0,0,2,0,-2
2911,1,0,3,0,-3
2912,1,1,256,1248,992
2913,1,0,64,0,-64
2914,1,0,73,0,-73
2915,1,1,1075,1273,198
2916,1,1,783,1321,538
2917,0,0,28,0,-28
2918,1,0,33,0,-33
2919,0,0,8,0,-8
2920,1,0,116,0,-116
2921,0,0,49,0,-49
2922,0,0,204,0,-204
2923,1,1,971,1567,596
2924,1,0,60,0,-60
2925,1,1,371,2232,1861
2926,1,0,5,0,-5
2927,1,0,10,0,-10
2928,1,1,32,1592,1560
2929,1,0,1,0,-1
2930,1,0,4,0,-4
2931,0,0,18,0,-18
2932,0,0,6,0,-6
2933,0,0,26,0,-26
2934,0,0,30,0,-30
2935,1,1,216,1626,1410
2936,0,0,1,0,-1
2937,0,0,106,0,-106
2938,0,0,43,0,-43
2939,1,1,367,1277,910
2940,1,1,579,1381,802
2941,0,0,84,0,-84
2942,1,0,38,0,-38
2943,1,0,3,0,-3
2944,1,0,70,0,-70
2945,0,0,16,0,-16
2946,0,0,5,0,-5
2947,1,0,144,0,-144
2948,0,0,2,0,-2
2949,0,0,1,0,-1
2950,1,0,47,0,-47
2951,0,0,31,0,-31
2952,1,1,81,2806,2725
2953,1,0,3,0,-3
2954,0,0,23,0,-23
2955,1,1,65,1282,1217
2956,1,0,73,0,-73
2957,0,0,70,0,-70
2958,1,1,209,1846,1637
2959,1,0,23,0,-23
2960,1,0,82,0,-82
2961,1,1,395,1725,1330
2962,1,0,32,0,-32
2963,0,0,31,0,-31
2964,0,0,146,0,-146
2965,0,0,100,0,-100
2966,1,0,79,0,-79
2967,0,0,139,0,-139
2968,1,1,461,1352,891
2969,1,0,0,0,0
2970,1,1,1211,1243,32
2971,1,1,281,1244,963
2972,1,0,60,0,-60
2973,1,0,14,0,-14
2974,0,0,71,0,-71
2975,0,0,22,0,-22
2976,1,0,53,0,-53
2977,1,1,540,1388,848
2978,0,0,79,0,-79
2979,0,0,67,0,-67
2980,0,0,38,0,-38
2981,0,0,10,0,-10
2982,1,1,171,1554,1383
2983,1,0,6,0,-6
2984,0,0,29,0,-29
2985,0,0,82,0,-82
2986,1,1,269,3685,3416
2987,1,0,27,0,-27
2988,1,1,88,1311,1223
2989,0,0,107,0,-107
2990,1,1,236,1254,1018
2991,0,0,17,0,-17
2992,1,1,896,1521,625
2993,0,0,23,0,-23
2994,1,1,695,1875,1180
2995,1,1,260,1241,981
2996,1,1,1279,2239,960
2997,0,0,77,0,-77
2998,0,0,13,0,-13
2999,0,0,19,0,-19
3000,0,0,15,0,-15
3001,1,0,68,0,-68
3002,1,0,102,0,-102
3003,1,1,990,1206,216
3004,1,1,384,1223,839
3005,1,0,48,0,-48
3006,1,0,77,0,-77
3007,0,0,8,0,-8
3008,0,0,45,0,-45
3009,1,0,31,0,-31
3010,0,0,47,0,-47
3011,1,1,1542,1493,-49
3012,0,0,61,0,-61
3013,1,1,558,1551,993
3014,1,1,181,2056,1875
3015,1,0,3,0,-3
3016,0,0,82,0,-82
3017,0,0,46,0,-46
3018,1,0,55,0,-55
3019,1,0,92,0,-92
3020,1,1,236,1399,1163
3021,1,1,176,1305,1129
3022,1,0,47,0,-47
3023,1,1,769,1417,648
3024,0,0,86,0,-86
3025,1,1,550,1328,778
3026,0,0,1,0,-1
3027,1,1,131,1647,1516
3028,1,1,1102,2415,1313
3029,1,0,12,0,-12
3030,1,0,67,0,-67
3031,0,0,246,0,-246
3032,1,0,34,0,-34
3033,0,0,73,0,-73
3034,0,0,22,0,-22
3035,0,0,29,0,-29
3036,1,0,205,0,-205
3037,1,1,73,1834,1761
3038,1,1,584,1590,1006
3039,1,0,119,0,-119
3040,1,0,29,0,-29
3041,1,0,139,0,-139
3042,1,0,4,0,-4
3043,0,0,95,0,-95
3044,1,1,695,1606,911
3045,0,0,20,0,-20
3046,1,0,18,0,-18
3047,1,1,288,1494,1206
3048,0,0,31,0,-31
3049,0,0,7,0,-7
3050,0,0,118,0,-118
3051,1,1,459,1376,917
3052,0,0,33,0,-33
3053,0,0,31,0,-31
3054,0,0,72,0,-72
3055,0,0,46,0,-46
3056,1,1,130,1718,1588
3057,0,0,30,0,-30
3058,1,1,1126,1555,429
3059,1,0,167,0,-167
3060,0,0,40,0,-40
3061,1,0,83,0,-83
3062,1,1,813,1279,466
3063,0,0,133,0,-133
3064,0,0,46,0,-46
3065,1,1,80,1326,1246
3066,1,1,242,2008,1766
3067,0,0,2,0,-2
3068,1,1,2588,1531,-1057
3069,0,0,2,0,-2
3070,1,0,16,0,-16
3071,1,1,235,1266,1031
3072,0,0,28,0,-28
3073,0,0,40,0,-40
3074,1,0,38,0,-38
3075,1,0,18,0,-18
3076,0,0,49,0,-49
3077,1,0,18,0,-18
3078,0,0,29,0,-29
3079,1,0,45,0,-45
3080,1,0,0,0,0
3081,1,0,76,0,-76
3082,0,0,160,0,-160
3083,0,0,0,0,0
3084,0,0,39,0,-39
3085,0,0,20,0,-20
3086,1,0,23,0,-23
3087,1,1,19,1260,1241
3088,1,1,74,3136,3062
3089,0,0,23,0,-23
3090,1,1,945,1204,259
3091,1,1,777,1367,590
3092,0,0,0,0,0
3093,1,1,1375,1303,-72
3094,1,0,9,0,-9
3095,1,1,204,1603,1399
3096,0,0,4,0,-4
3097,1,1,598,1439,841
3098,0,0,23,0,-23
3099,1,1,697,2378,1681
3100,0,0,144,0,-144
3101,0,0,76,0,-76
3102,0,0,7,0,-7
3103,1,0,117,0,-117
3104,0,0,65,0,-65
3105,1,0,6,0,-6
3106,1,0,37,0,-37
3107,1,1,703,1377,674
3108,1,1,310,1214,904
3109,1,1,563,1368,805
3110,0,0,97,0,-97
3111,1,0,103,0,-103
3112,1,0,76,0,-76
3113,0,0,29,0,-29
3114,0,0,41,0,-41
3115,0,0,92,0,-92
3116,1,1,516,1268,752
3117,1,1,577,1222,645
3118,0,0,1,0,-1
3119,0,0,30,0,-30
3120,0,0,41,0,-41
3121,1,0,125,0,-125
3122,1,0,21,0,-21
3123,0,0,82,0,-82
3124,0,0,55,0,-55
3125,1,1,608,1428,820
3126,0,0,188,0,-188
3127,1,1,546,1571,1025
3128,1,0,110,0,-110
3129,1,1,157,1281,1124
3130,0,0,59,0,-59
3131,0,0,1,0,-1
3132,1,1,2841,2192,-649
3133,0,0,7,0,-7
3134,1,1,1497,1513,16
3135,1,1,953,1633,680
3136,0,0,7,0,-7
3137,0,0,2,0,-2
3138,0,0,61,0,-61
3139,1,1,96,1269,1173
3140,1,1,691,1291,600
3141,1,1,2550,1739,-811
3142,1,0,71,0,-71
3143,1,0,10,0,-10
3144,0,0,38,0,-38
3145,1,1,331,1425,1094
3146,0,0,169,0,-169
3147,0,0,6,0,-6
3148,1,1,209,1879,1670
3149,0,0,18,0,-18
3150,0,0,82,0,-82
3151,0,0,110,0,-110
3152,0,0,23,0,-23
3153,0,0,10,0,-10
3154,1,1,248,1255,1007
3155,1,1,754,3535,2781
3156,0,0,4,0,-4
3157,1,1,599,1423,824
3158,1,0,8,0,-8
3159,0,0,46,0,-46
3160,0,0,21,0,-21
3161,0,0,57,0,-57
3162,1,0,17,0,-17
3163,1,1,217,1586,1369
3164,0,0,19,0,-19
3165,1,0,7,0,-7
3166,1,0,11,0,-11
3167,0,0,35,0,-35
3168,0,0,0,0,0
3169,1,1,138,1491,1353
3170,1,1,553,1535,982
3171,1,1,556,1359,803
3172,1,1,202,1466,1264
3173,1,1,471,3268,2797
3174,1,1,1103,2817,1714
3175,1,1,363,1240,877
3176,0,0,318,0,-318
3177,1,1,282,1439,1157
3178,1,0,16,0,-16
3179,0,0,21,0,-21
3180,1,0,178,0,-178
3181,0,0,62,0,-62
3182,1,0,0,0,0
3183,1,1,51,1580,1529
3184,1,0,76,0,-76
3185,0,0,120,0,-120
3186,0,0,32,0,-32
3187,0,0,75,0,-75
3188,1,1,436,1253,817
3189,1,1,206,1549,1343
3190,0,0,9,0,-9
3191,0,0,15,0,-15
3192,0,0,24,0,-24
3193,1,1,335,1238,903
3194,1,0,57,0,-57
3195,0,0,12,0,-12
3196,1,0,21,0,-21
3197,0,0,19,0,-19
3198,0,0,18,0,-18
3199,0,0,55,0,-55
3200,1,1,352,1919,1567
3201,1,1,1369,1675,306
3202,1,0,18,0,-18
3203,1,0,7,0,-7
3204,1,1,802,1469,667
3205,1,1,443,1254,811
3206,1,1,208,2173,1965
3207,0,0,23,0,-23
3208,1,1,128,2330,2202
3209,0,0,147,0,-147
3210,1,1,2132,1361,-771
3211,1,1,546,1545,999
3212,0,0,47,0,-47
3213,1,0,13,0,-13
3214,0,0,0,0,0
3215,0,0,181,0,-181
3216,1,0,44,0,-44
3217,1,0,48,0,-48
3218,0,0,73,0,-73
3219,1,0,140,0,-140
3220,0,0,9,0,-9
3221,1,0,11,0,-11
3222,1,1,92,1331,1239
3223,1,0,13,0,-13
3224,0,0,41,0,-41
3225,1,1,406,1287,881
3226,1,1,544,1508,964
3227,1,1,2088,1324,-764
3228,1,0,9,0,-9
3229,0,0,1,0,-1
3230,1,0,100,0,-100
3231,1,0,27,0,-27
3232,1,0,11,0,-11
3233,0,0,2,0,-2
3234,0,0,95,0,-95
3235,0,0,157,0,-157
3236,0,0,41,0,-41
3237,0,0,227,0,-227
3238,1,0,109,0,-109
3239,1,0,11,0,-11
3240,1,0,89,0,-89
3241,0,0,37,0,-37
3242,0,0,10,0,-10
3243,1,1,714,1332,618
3244,0,0,25,0,-25
3245,1,1,90,1518,1428
3246,0,0,1,0,-1
3247,1,1,703,1335,632
3248,1,1,454,1337,883
3249,1,1,345,1774,1429
3250,1,0,22,0,-22
3251,1,1,535,1415,880
3252,1,1,108,1530,1422
3253,1,0,97,0,-97
3254,0,0,102,0,-102
3255,1,0,17,0,-17
3256,1,0,3,0,-3
3257,0,0,95,0,-95
3258,0,0,18,0,-18
3259,1,0,46,0,-46
3260,0,0,25,0,-25
3261,1,0,33,0,-33
3262,0,0,36,0,-36
3263,0,0,32,0,-32
3264,1,1,2793,1412,-1381
3265,1,1,834,1271,437
3266,1,0,61,0,-61
3267,0,0,25,0,-25
3268,1,0,11,0,-11
3269,1,0,8,0,-8
3270,1,1,153,1251,1098
3271,1,0,2,0,-2
3272,1,0,97,0,-97
3273,0,0,119,0,-119
3274,0,0,43,0,-43
3275,1,1,193,1777,1584
3276,1,1,368,1265,897
3277,1,0,93,0,-93
3278,1,0,39,0,-39
3279,1,0,91,0,-91
3280,1,0,50,0,-50
3281,1,0,19,0,-19
3282,1,1,391,1346,955
3283,0,0,6,0,-6
3284,0,0,33,0,-33
3285,1,0,160,0,-160
3286,0,0,14,0,-14
3287,1,0,6,0,-6
3288,1,1,2307,1207,-1100
3289,1,1,1674,1701,27
3290,1,0,0,0,0
3291,0,0,157,0,-157
3292,0,0,75,0,-75
3293,1,0,51,0,-51
3294,1,1,194,2124,1930
3295,0,0,48,0,-48
3296,1,1,1268,2037,769
3297,0,0,205,0,-205
3298,1,0,63,0,-63
3299,1,0,87,0,-87
3300,0,0,3,0,-3
3301,1,1,406,1897,1491
3302,1,1,120,1289,1169
3303,1,0,70,0,-70
3304,0,0,12,0,-12
3305,0,0,8,0,-8
3306,1,1,299,1618,1319
3307,1,1,314,2287,1973
3308,0,0,49,0,-49
3309,1,0,29,0,-29
3310,0,0,58,0,-58
3311,1,1,1351,1218,-133
3312,1,0,24,0,-24
3313,0,0,66,0,-66
3314,0,0,25,0,-25
3315,1,1,235,1215,980
3316,1,1,191,2130,1939
3317,1,1,67,1275,1208
3318,0,0,1,0,-1
3319,1,1,324,1563,1239
3320,1,1,1287,1308,21
3321,1,0,3,0,-3
3322,0,0,4,0,-4
3323,0,0,38,0,-38
3324,1,0,100,0,-100
3325,0,0,10,0,-10
3326,1,0,17,0,-17
3327,1,0,2,0,-2
3328,1,0,107,0,-107
3329,1,0,124,0,-124
3330,0,0,39,0,-39
3331,1,0,38,0,-38
3332,0,0,55,0,-55
3333,0,0,70,0,-70
3334,1,1,182,2470,2288
3335,0,0,49,0,-49
3336,1,1,227,1263,1036
3337,0,0,52,0,-52
3338,0,0,14,0,-14
3339,1,0,43,0,-43
3340,0,0,33,0,-33
3341,1,0,86,0,-86
3342,0,0,42,0,-42
3343,1,0,39,0,-39
3344,0,0,165,0,-165
3345,1,0,1,0,-1
3346,0,0,24,0,-24
3347,1,0,0,0,0
3348,0,0,16,0,-16
3349,0,0,20,0,-20
3350,0,0,24,0,-24
3351,1,1,1578,1330,-248
3352,1,0,32,0,-32
3353,1,1,1388,1320,-68
3354,1,0,14,0,-14
3355,1,0,27,0,-27
3356,0,0,19,0,-19
3357,0,0,48,0,-48
3358,1,1,286,1769,1483
3359,0,0,120,0,-120
3360,0,0,4,0,-4
3361,1,0,24,0,-24
3362,0,0,0,0,0
3363,1,1,2028,1392,-636
3364,0,0,73,0,-73
3365,1,0,18,0,-18
3366,1,1,218,1518,1300
3367,1,0,70,0,-70
3368,1,1,173,1921,1748
3369,1,0,26,0,-26
3370,0,0,24,0,-24
3371,0,0,31,0,-31
3372,0,0,41,0,-41
3373,0,0,0,0,0
3374,1,1,432,1407,975
3375,0,0,16,0,-16
3376,1,1,417,1424,1007
3377,0,0,84,0,-84
3378,1,0,3,0,-3
3379,0,0,0,0,0
3380,1,0,36,0,-36
3381,0,0,90,0,-90
3382,0,0,63,0,-63
3383,1,0,35,0,-35
3384,1,0,86,0,-86
3385,1,0,7,0,-7
3386,0,0,35,0,-35
3387,1,0,58,0,-58
3388,1,0,22,0,-22
3389,0,0,65,0,-65
3390,1,0,22,0,-22
3391,1,0,37,0,-37
3392,0,0,113,0,-113
3393,1,0,2,0,-2
3394,0,0,1,0,-1
3395,0,0,14,0,-14
3396,1,0,2,0,-2
3397,1,1,489,1385,896
3398,1,0,64,0,-64
3399,0,0,22,0,-22
3400,0,0,33,0,-33
3401,1,1,1428,1725,297
3402,1,0,15,0,-15
3403,1,0,140,0,-140
3404,1,1,334,1279,945
3405,0,0,0,0,0
3406,1,1,189,1305,1116
3407,1,0,34,0,-34
3408,1,0,26,0,-26
3409,1,1,189,1217,1028
3410,0,0,91,0,-91
3411,1,0,2,0,-2
3412,0,0,9,0,-9
3413,0,0,64,0,-64
3414,1,1,1212,1485,273
3415,1,0,124,0,-124
3416,0,0,97,0,-97
3417,0,0,18,0,-18
3418,0,0,46,0,-46
3419,1,0,1,0,-1
3420,1,1,1685,1460,-225
3421,0,0,166,0,-166
3422,1,0,72,0,-72
3423,0,0,0,0,0
3424,1,1,881,1569,688
3425,1,0,11,0,-11
3426,0,0,10,0,-10
3427,0,0,4,0,-4
3428,0,0,48,0,-48
3429,1,0,66,0,-66
3430,1,1,1553,1301,-252
3431,1,1,1843,1233,-610
3432,0,0,15,0,-15
3433,0,0,102,0,-102
3434,0,0,41,0,-41
3435,1,1,1782,1621,-161
3436,1,0,138,0,-138
3437,1,0,14,0,-14
3438,1,0,116,0,-116
3439,1,1,45,1239,1194
3440,1,0,182,0,-182
3441,1,0,42,0,-42
3442,1,1,457,1213,756
3443,0,0,45,0,-45
3444,1,0,107,0,-107
3445,0,0,3,0,-3
3446,0,0,38,0,-38
3447,1,1,122,1400,1278
3448,0,0,4,0,-4
3449,0,0,54,0,-54
3450,1,0,38,0,-38
3451,0,0,118,0,-118
3452,1,1,387,1211,824
3453,1,1,356,1232,876
3454,0,0,28,0,-28
3455,1,1,582,2130,1548
3456,1,1,468,1773,1305
3457,0,0,2,0,-2
3458,1,0,18,0,-18
3459,1,1,679,4876,4197
3460,1,1,732,1331,599
3461,1,1,354,1335,981
3462,0,0,141,0,-141
3463,1,0,19,0,-19
3464,1,0,114,0,-114
3465,1,1,103,1478,1375
3466,1,1,1752,1922,170
3467,1,1,477,1338,861
3468,1,1,891,1746,855
3469,1,1,440,1395,955
3470,1,1,674,1220,546
3471,1,1,627,2357,1730
3472,0,0,7,0,-7
3473,0,0,20,0,-20
3474,1,1,193,1942,1749
3475,0,0,207,0,-207
3476,1,1,183,1229,1046
3477,0,0,147,0,-147
3478,1,1,109,1858,1749
3479,1,1,107,2794,2687
3480,0,0,52,0,-52
3481,0,0,7,0,-7
3482,0,0,211,0,-211
3483,0,0,37,0,-37
3484,1,0,17,0,-17
3485,1,1,452,1453,1001
3486,0,0,91,0,-91
3487,1,0,85,0,-85
3488,1,1,2133,1277,-856
3489,1,1,512,2595,2083
3490,1,0,3,0,-3
3491,0,0,29,0,-29
3492,1,0,6,0,-6
3493,1,0,53,0,-53
3494,0,0,44,0,-44
3495,0,0,0,0,0
3496,1,1,201,1387,1186
3497,1,1,157,1442,1285
3498,1,1,770,1295,525
3499,0,0,18,0,-18
3500,0,0,7,0,-7
3501,1,1,241,3795,3554
3502,1,1,458,1261,803
3503,1,0,36,0,-36
3504,1,1,342,1299,957
3505,1,1,38,1319,1281
3506,1,1,253,1471,1218
3507,1,0,22,0,-22
3508,0,0,8,0,-8
3509,1,1,133,1221,1088
3510,0,0,23,0,-23
3511,0,0,5,0,-5
3512,1,1,26,2331,2305
3513,0,0,237,0,-237
3514,0,0,118,0,-118
3515,1,1,66,1719,1653
3516,1,0,98,0,-98
3517,0,0,81,0,-81
3518,0,0,3,0,-3
3519,1,0,7,0,-7
3520,1,0,8,0,-8
3521,1,0,28,0,-28
3522,0,0,29,0,-29
3523,1,0,12,0,-12
3524,1,1,1454,1259,-195
3525,1,1,521,1202,681
3526,0,0,27,0,-27
3527,0,0,32,0,-32
3528,0,0,54,0,-54
3529,1,0,19,0,-19
3530,0,0,8,0,-8
3531,1,0,18,0,-18
3532,1,0,2,0,-2
3533,0,0,1,0,-1
3534,0,0,47,0,-47
3535,1,1,648,1256,608
3536,0,0,15,0,-15
3537,1,1,311,1405,1094
3538,1,0,66,0,-66
3539,1,1,2017,1216,-801
3540,0,0,0,0,0
3541,1,0,78,0,-78
3542,0,0,2,0,-2
3543,1,0,42,0,-42
3544,1,0,44,0,-44
3545,1,1,169,1612,1443
3546,1,1,847,1484,637
3547,1,0,7,0,-7
3548,1,0,117,0,-117
3549,1,0,45,0,-45
3550,1,1,872,1473,601
3551,1,0,99,0,-99
3552,1,0,11,0,-11
3553,1,1,376,2090,1714
3554,1,0,50,0,-50
3555,0,0,0,0,0
3556,1,0,11,0,-11
3557,0,0,17,0,-17
3558,1,1,666,1486,820
3559,0,0,14,0,-14
3560,1,0,16,0,-16
3561,0,0,47,0,-47
3562,1,1,298,1458,1160
3563,0,0,29,0,-29
3564,0,0,29,0,-29
3565,1,0,112,0,-112
3566,1,0,174,0,-174
3567,0,0,21,0,-21
3568,0,0,24,0,-24
3569,1,1,30,1287,1257
3570,1,0,18,0,-18
3571,1,0,8,0,-8
3572,1,0,30,0,-30
3573,0,0,62,0,-62
3574,1,0,58,0,-58
3575,1,0,95,0,-95
3576,1,0,35,0,-35
3577,1,0,30,0,-30
3578,0,0,91,0,-91
3579,0,0,143,0,-143
3580,0,0,205,0,-205
3581,1,0,43,0,-43
3582,1,0,21,0,-21
3583,1,1,1464,1353,-111
3584,0,0,125,0,-125
3585,0,0,7,0,-7
3586,1,1,222,1558,1336
3587,1,1,793,2399,1606
3588,0,0,22,0,-22
3589,0,0,46,0,-46
3590,0,0,142,0,-142
3591,1,0,36,0,-36
3592,0,0,4,0,-4
3593,1,0,28,0,-28
3594,1,0,20,0,-20
3595,1,1,962,1394,432
3596,0,0,18,0,-18
3597,1,0,11,0,-11
3598,0,0,88,0,-88
3599,1,0,170,0,-170
3600,1,0,49,0,-49
3601,1,1,175,1471,1296
3602,0,0,135,0,-135
3603,0,0,57,0,-57
3604,0,0,132,0,-132
3605,0,0,13,0,-13
3606,0,0,29,0,-29
3607,1,0,80,0,-80
3608,1,1,575,1500,925
3609,0,0,40,0,-40
3610,1,0,3,0,-3
3611,0,0,11,0,-11
3612,0,0,30,0,-30
3613,0,0,24,0,-24
3614,1,1,241,1875,1634
3615,0,0,31,0,-31
3616,1,1,1138,2213,1075
3617,0,0,107,0,-107
3618,0,0,16,0,-16
3619,0,0,15,0,-15
3620,1,0,26,0,-26
3621,1,1,305,1943,1638
3622,1,0,1,0,-1
3623,0,0,5,0,-5
3624,1,0,5,0,-5
3625,1,0,87,0,-87
3626,1,1,689,1443,754
3627,1,1,297,1446,1149
3628,0,0,0,0,0
3629,1,1,23,1497,1474
3630,0,0,6,0,-6
3631,0,0,29,0,-29
3632,1,1,205,2258,2053
3633,0,0,12,0,-12
3634,0,0,83,0,-83
3635,1,1,1687,2644,957
3636,1,0,67,0,-67
3637,1,1,478,1643,1165
3638,1,0,66,0,-66
3639,0,0,13,0,-13
3640,0,0,132,0,-132
3641,0,0,26,0,-26
3642,1,1,663,1735,1072
3643,1,0,126,0,-126
3644,1,0,16,0,-16
3645,0,0,95,0,-95
3646,1,0,228,0,-228
3647,0,0,70,0,-70
3648,1,1,672,1209,537
3649,1,1,183,1409,1226
3650,1,1,720,1283,563
3651,1,0,15,0,-15
3652,1,0,48,0,-48
3653,1,1,543,1694,1151
3654,1,1,1180,1288,108
3655,1,1,1709,1279,-430
3656,0,0,66,0,-66
3657,1,0,90,0,-90
3658,0,0,16,0,-16
3659,1,1,1067,1569,502
3660,0,0,42,0,-42
3661,1,1,727,1834,1107
3662,1,1,602,1453,851
3663,1,1,956,1229,273
3664,1,0,3,0,-3
3665,0,0,19,0,-19
3666,1,0,35,0,-35
3667,0,0,36,0,-36
3668,0,0,29,0,-29
3669,0,0,43,0,-43
3670,1,0,43,0,-43
3671,0,0,21,0,-21
3672,1,0,9,0,-9
3673,0,0,31,0,-31
3674,0,0,23,0,-23
3675,1,1,828,1266,438
3676,1,1,641,1894,1253
3677,0,0,43,0,-43
3678,1,1,636,1417,781
3679,0,0,176,0,-176
3680,1,1,755,1614,859
3681,0,0,9,0,-9
3682,1,1,117,1612,1495
3683,1,1,503,1246,743
3684,1,1,115,2015,1900
3685,0,0,28,0,-28
3686,0,0,82,0,-82
3687,0,0,53,0,-53
3688,0,0,52,0,-52
3689,1,0,2,0,-2
3690,1,1,86,1260,1174
3691,0,0,11,0,-11
3692,1,0,21,0,-21
3693,1,1,119,1297,1178
3694,1,1,338,1460,1122
3695,0,0,8,0,-8
3696,0,0,1,0,-1
3697,1,1,2299,1320,-979
3698,1,1,63,1499,1436
3699,1,0,54,0,-54
3700,1,0,28,0,-28
3701,1,1,1069,1259,190
3702,0,0,5,0,-5
3703,0,0,74,0,-74
3704,1,1,1664,1714,50
3705,1,1,433,1233,800
3706,1,1,113,1410,1297
3707,1,0,5,0,-5
3708,1,0,75,0,-75
3709,1,1,254,1663,1409
3710,0,0,50,0,-50
3711,1,1,335,2209,1874
3712,1,0,44,0,-44
3713,1,1,938,1595,657
3714,1,1,44,2160,2116
3715,1,1,544,1676,1132
3716,0,0,81,0,-81
3717,0,0,270,0,-270
3718,0,0,17,0,-17
3719,1,1,345,1284,939
3720,0,0,176,0,-176
3721,0,0,44,0,-44
3722,1,0,3,0,-3
3723,1,0,13,0,-13
3724,0,0,165,0,-165
3725,1,1,1481,1535,54
3726,0,0,20,0,-20
3727,1,1,630,1533,903
3728,1,0,19,0,-19
3729,0,0,15,0,-15
3730,1,1,422,1255,833
3731,1,0,32,0,-32
3732,0,0,98,0,-98
3733,1,1,520,1320,800
3734,0,0,16,0,-16
3735,0,0,16,0,-16
3736,1,0,27,0,-27
3737,0,0,20,0,-20
3738,1,0,23,0,-23
3739,1,0,85,0,-85
3740,1,0,162,0,-162
3741,1,1,242,3085,2843
3742,1,1,122,1774,1652
3743,0,0,1,0,-1
3744,1,1,369,3565,3196
3745,1,0,26,0,-26
3746,1,1,1625,1243,-382
3747,0,0,35,0,-35
3748,0,0,23,0,-23
3749,1,1,935,1424,489
3750,0,0,2,0,-2
3751,0,0,51,0,-51
3752,0,0,30,0,-30
3753,1,1,282,1723,1441
3754,1,1,38,3639,3601
3755,1,0,54,0,-54
3756,1,1,61,1788,1727
3757,0,0,122,0,-122
3758,1,0,33,0,-33
3759,1,1,236,1310,1074
3760,1,0,1,0,-1
3761,0,0,59,0,-59
3762,1,1,637,1455,818
3763,1,0,33,0,-33
3764,0,0,8,0,-8
3765,1,1,441,1522,1081
3766,0,0,39,0,-39
3767,1,0,53,0,-53
3768,0,0,6,0,-6
3769,0,0,10,0,-10
3770,1,0,9,0,-9
3771,1,1,144,1612,1468
3772,1,0,15,0,-15
3773,0,0,78,0,-78
3774,1,1,212,1298,1086
3775,1,1,1255,1210,-45
3776,1,0,18,0,-18
3777,1,1,130,1324,1194
3778,1,0,77,0,-77
3779,1,0,10,0,-10
3780,0,0,13,0,-13
3781,1,1,217,1413,1196
3782,1,0,107,0,-107
3783,0,0,47,0,-47
3784,1,1,393,1296,903
3785,1,0,31,0,-31
3786,1,0,2,0,-2
3787,0,0,43,0,-43
3788,1,1,337,1872,1535
3789,1,1,515,1521,1006
3790,1,1,180,1585,1405
3791,0,0,26,0,-26
3792,1,0,22,0,-22
3793,1,1,268,1579,1311
3794,0,0,7,0,-7
3795,1,0,6,0,-6
3796,1,1,41,2576,2535
3797,0,0,100,0,-100
3798,0,0,27,0,-27
3799,1,1,156,1307,1151
3800,1,1,286,1214,928
3801,1,0,1,0,-1
3802,1,0,140,0,-140
3803,0,0,24,0,-24
3804,0,0,3,0,-3
3805,0,0,19,0,-19
3806,1,1,736,1480,744
3807,0,0,27,0,-27
3808,1,0,67,0,-67
3809,1,0,4,0,-4
3810,1,0,1,0,-1
3811,0,0,49,0,-49
3812,0,0,14,0,-14
3813,1,1,540,1378,838
3814,1,0,14,0,-14
3815,1,1,678,1302,624
3816,1,1,570,1349,779
3817,0,0,149,0,-149
3818,1,0,54,0,-54
3819,1,0,64,0,-64
3820,1,1,301,1736,1435
3821,0,0,71,0,-71
3822,1,0,28,0,-28
3823,1,0,5,0,-5
3824,1,1,544,1636,1092
3825,1,1,106,1276,1170
3826,0,0,7,0,-7
3827,1,1,1545,1928,383
3828,1,1,22,1362,1340
3829,0,0,10,0,-10
3830,1,0,58,0,-58
3831,1,1,307,1230,923
3832,1,1,745,1220,475
3833,1,0,87,0,-87
3834,1,0,97,0,-97
3835,1,1,197,1308,1111
3836,1,0,45,0,-45
3837,1,0,177,0,-177
3838,0,0,27,0,-27
3839,1,0,110,0,-110
3840,0,0,61,0,-61
3841,0,0,2,0,-2
3842,1,1,306,2264,1958
3843,1,0,71,0,-71
3844,0,0,17,0,-17
3845,0,0,48,0,-48
3846,0,0,11,0,-11
3847,1,1,49,1362,1313
3848,1,1,52,1597,1545
3849,1,0,52,0,-52
3850,1,1,273,1280,1007
3851,1,0,229,0,-229
3852,1,1,908,1860,952
3853,1,0,29,0,-29
3854,1,1,413,1607,1194
3855,1,1,607,1220,613
3856,1,0,5,0,-5
3857,0,0,14,0,-14
3858,1,1,325,1212,887
3859,0,0,75,0,-75
3860,1,1,368,1657,1289
3861,0,0,11,0,-11
3862,1,1,487,1671,1184
3863,0,0,62,0,-62
3864,0,0,20,0,-20
3865,0,0,105,0,-105
3866,1,1,1110,1329,219
3867,1,1,453,1889,1436
3868,1,0,4,0,-4
3869,1,0,27,0,-27
3870,0,0,8,0,-8
3871,1,0,17,0,-17
3872,1,0,49,0,-49
3873,0,0,99,0,-99
3874,1,0,27,0,-27
3875,0,0,34,0,-34
3876,1,1,1040,1442,402
3877,1,0,52,0,-52
3878,1,0,11,0,-11
3879,1,1,485,1480,995
3880,0,0,34,0,-34
3881,1,1,258,1414,1156
3882,1,0,1,0,-1
3883,0,0,127,0,-127
3884,0,0,171,0,-171
3885,0,0,15,0,-15
3886,1,1,202,1638,1436
3887,0,0,6,0,-6
3888,1,1,160,1258,1098
3889,1,0,145,0,-145
3890,1,0,60,0,-60
3891,1,1,197,2051,1854
3892,1,1,285,1593,1308
3893,1,1,87,1669,1582
3894,0,0,56,0,-56
3895,1,1,99,1561,1462
3896,0,0,78,0,-78
3897,0,0,41,0,-41
3898,1,0,9,0,-9
3899,0,0,142,0,-142
3900,1,1,249,1685,1436
3901,0,0,123,0,-123
3902,0,0,5,0,-5
3903,0,0,240,0,-240
3904,0,0,21,0,-21
3905,1,0,16,0,-16
3906,1,0,85,0,-85
3907,0,0,15,0,-15
3908,0,0,65,0,-65
3909,0,0,35,0,-35
3910,0,0,42,0,-42
3911,0,0,58,0,-58
3912,0,0,220,0,-220
3913,1,1,252,1977,1725
3914,0,0,16,0,-16
3915,0,0,47,0,-47
3916,0,0,8,0,-8
3917,1,1,2510,1580,-930
3918,0,0,45,0,-45
3919,1,1,216,1868,1652
3920,1,1,29,1924,1895
3921,0,0,9,0,-9
3922,1,1,417,1200,783
3923,1,1,295,1515,1220
3924,1,1,750,1450,700
3925,0,0,0,0,0
3926,1,1,193,1873,1680
3927,1,1,109,1856,1747
3928,1,0,80,0,-80
3929,1,1,753,1522,769
3930,0,0,46,0,-46
3931,1,0,13,0,-13
3932,1,0,42,0,-42
3933,0,0,70,0,-70
3934,0,0,18,0,-18
3935,1,0,20,0,-20
3936,1,0,37,0,-37
3937,0,0,69,0,-69
3938,0,0,52,0,-52
3939,1,0,104,0,-104
3940,1,0,1,0,-1
3941,0,0,80,0,-80
3942,1,0,37,0,-37
3943,0,0,75,0,-75
3944,0,0,114,0,-114
3945,1,0,60,0,-60
3946,0,0,161,0,-161
3947,1,1,84,1385,1301
3948,0,0,53,0,-53
3949,0,0,25,0,-25
3950,0,0,142,0,-142
3951,1,1,529,1423,894
3952,0,0,23,0,-23
3953,0,0,11,0,-11
3954,0,0,3,0,-3
3955,1,0,51,0,-51
3956,1,0,256,0,-256
3957,0,0,19,0,-19
3958,1,1,2059,1507,-552
3959,1,1,1388,1638,250
3960,1,0,93,0,-93
3961,1,0,8,0,-8
3962,1,1,498,2164,1666
3963,1,1,78,1377,1299
3964,1,1,1210,1234,24
3965,1,0,89,0,-89
3966,1,1,129,1218,1089
3967,1,1,1153,1207,54
3968,1,0,14,0,-14
3969,1,0,9,0,-9
3970,1,0,24,0,-24
3971,1,1,115,1271,1156
3972,0,0,2,0,-2
3973,1,0,4,0,-4
3974,1,0,4,0,-4
3975,1,1,2333,1403,-930
3976,0,0,5,0,-5
3977,1,0,36,0,-36
3978,1,1,526,1240,714
3979,1,1,184,1209,1025
3980,0,0,26,0,-26
3981,1,1,99,1479,1380
3982,0,0,29,0,-29
3983,1,0,146,0,-146
3984,1,0,9,0,-9
3985,1,0,250,0,-250
3986,1,1,212,1555,1343
3987,0,0,41,0,-41
3988,0,0,70,0,-70
3989,0,0,12,0,-12
3990,1,1,1635,1308,-327
3991,1,1,345,1459,1114
3992,1,0,11,0,-11
3993,0,0,48,0,-48
3994,1,1,673,1702,1029
3995,1,1,83,1376,1293
3996,1,0,6,0,-6
3997,0,0,180,0,-180
3998,1,1,191,1807,1616
3999,1,1,100,1304,1204
4000,1,1,1463,1611,148
4001,1,0,34,0,-34
4002,1,0,1,0,-1
4003,1,1,873,1308,435
4004,0,0,111,0,-111
4005,0,0,175,0,-175
4006,1,0,42,0,-42
4007,1,1,58,1202,1144
4008,0,0,86,0,-86
4009,1,0,5,0,-5
4010,0,0,22,0,-22
4011,0,0,62,0,-62
4012,0,0,100,0,-100
4013,1,0,152,0,-152
4014,0,0,123,0,-123
4015,1,0,20,0,-20
4016,1,0,5,0,-5
4017,0,0,92,0,-92
4018,0,0,8,0,-8
4019,1,1,481,1693,1212
4020,0,0,24,0,-24
4021,1,1,364,1727,1363
4022,1,1,623,1744,1121
4023,0,0,85,0,-85
4024,0,0,27,0,-27
4025,0,0,13,0,-13
4026,0,0,34,0,-34
4027,1,0,17,0,-17
4028,0,0,61,0,-61
4029,0,0,10,0,-10
4030,1,0,11,0,-11
4031,1,1,745,1305,560
4032,0,0,7,0,-7
4033,0,0,46,0,-46
4034,0,0,73,0,-73
4035,0,0,17,0,-17
4036,1,0,39,0,-39
4037,1,1,467,1467,1000
4038,1,1,204,1334,1130
4039,1,0,14,0,-14
4040,1,1,378,1851,1473
4041,0,0,56,0,-56
4042,0,0,82,0,-82
4043,0,0,41,0,-41
4044,0,0,136,0,-136
4045,1,0,25,0,-25
4046,1,1,576,1234,658
4047,0,0,135,0,-135
4048,0,0,201,0,-201
4049,0,0,25,0,-25
4050,1,0,1,0,-1
4051,1,0,57,0,-57
4052,1,1,327,1212,885
4053,1,0,26,0,-26
4054,1,1,1410,2014,604
4055,0,0,43,0,-43
4056,0,0,20,0,-20
4057,0,0,16,0,-16
4058,1,1,802,1359,557
4059,1,0,42,0,-42
4060,0,0,34,0,-34
4061,0,0,23,0,-23
4062,1,1,527,1665,1138
4063,1,1,1073,2047,974
4064,0,0,135,0,-135
4065,0,0,160,0,-160
4066,0,0,2,0,-2
4067,0,0,21,0,-21
4068,0,0,68,0,-68
4069,1,1,1559,1436,-123
4070,0,0,135,0,-135
4071,1,1,1037,1489,452
4072,1,1,814,1432,618
4073,1,1,806,3126,2320
4074,0,0,50,0,-50
4075,1,1,906,1700,794
4076,1,1,184,1403,1219
4077,0,0,14,0,-14
4078,0,0,11,0,-11
4079,0,0,27,0,-27
4080,0,0,16,0,-16
4081,0,0,77,0,-77
4082,0,0,67,0,-67
4083,0,0,8,0,-8
4084,1,0,18,0,-18
4085,1,0,19,0,-19
4086,1,0,68,0,-68
4087,0,0,76,0,-76
4088,1,0,13,0,-13
4089,1,0,8,0,-8
4090,0,0,17,0,-17
4091,1,0,7,0,-7
4092,1,1,974,1261,287
4093,1,0,18,0,-18
4094,0,0,138,0,-138
4095,1,1,622,1240,618
4096,0,0,81,0,-81
4097,0,0,41,0,-41
4098,0,0,0,0,0
4099,0,0,156,0,-156
4100,1,1,399,1532,1133
4101,0,0,3,0,-3
4102,0,0,94,0,-94
4103,0,0,8,0,-8
4104,0,0,28,0,-28
4105,1,1,112,1422,1310
4106,0,0,170,0,-170
4107,0,0,27,0,-27
4108,1,1,61,1374,1313
4109,1,0,26,0,-26
4110,0,0,53,0,-53
4111,0,0,8,0,-8
4112,0,0,30,0,-30
4113,0,0,42,0,-42
4114,1,1,250,1418,1168
4115,1,1,449,1395,946
4116,0,0,67,0,-67
4117,1,1,1119,1465,346
4118,1,0,19,0,-19
4119,1,1,504,1356,852
4120,0,0,66,0,-66
4121,1,0,78,0,-78
4122,1,0,32,0,-32
4123,1,1,1036,1271,235
4124,1,0,19,0,-19
4125,1,0,41,0,-41
4126,1,0,6,0,-6
4127,1,0,42,0,-42
4128,0,0,26,0,-26
4129,1,0,6,0,-6
4130,0,0,38,0,-38
4131,1,0,10,0,-10
4132,1,0,134,0,-134
4133,0,0,61,0,-61
4134,0,0,7,0,-7
4135,0,0,46,0,-46
4136,0,0,101,0,-101
4137,1,0,36,0,-36
4138,1,1,272,1234,962
4139,0,0,251,0,-251
4140,1,1,479,1551,1072
4141,0,0,58,0,-58
4142,0,0,12,0,-12
4143,0,0,15,0,-15
4144,1,0,168,0,-168
4145,1,0,48,0,-48
4146,1,1,257,1456,1199
4147,0,0,8,0,-8
4148,0,0,98,0,-98
4149,1,1,2541,1798,-743
4150,1,1,349,1465,1116
4151,0,0,1,0,-1
4152,1,0,11,0,-11
4153,0,0,4,0,-4
4154,0,0,50,0,-50
4155,1,1,478,1344,866
4156,1,1,815,1255,440
4157,1,1,517,1553,1036
4158,0,0,69,0,-69
4159,0,0,31,0,-31
4160,0,0,29,0,-29
4161,1,0,59,0,-59
4162,1,0,88,0,-88
4163,1,1,138,1375,1237
4164,1,1,636,1241,605
4165,1,0,85,0,-85
4166,1,0,9,0,-9
4167,0,0,33,0,-33
4168,1,0,136,0,-136
4169,1,0,13,0,-13
4170,1,0,50,0,-50
4171,0,0,37,0,-37
4172,1,1,756,1230,474
4173,0,0,3,0,-3
4174,1,0,13,0,-13
4175,0,0,46,0,-46
4176,1,0,2,0,-2
4177,1,0,32,0,-32
4178,0,0,21,0,-21
4179,0,0,9,0,-9
4180,0,0,8,0,-8
4181,1,1,132,1309,1177
4182,1,0,26,0,-26
4183,0,0,15,0,-15
4184,0,0,0,0,0
4185,0,0,44,0,-44
4186,0,0,79,0,-79
4187,0,0,46,0,-46
4188,1,1,512,1443,931
4189,1,1,2241,1950,-291
4190,0,0,192,0,-192
4191,0,0,110,0,-110
4192,0,0,22,0,-22
4193,1,0,27,0,-27
4194,1,0,44,0,-44
4195,1,0,4,0,-4
4196,1,1,67,1270,1203
4197,1,1,142,1601,1459
4198,1,0,7,0,-7
4199,0,0,61,0,-61
4200,1,0,1,0,-1
4201,0,0,21,0,-21
4202,1,0,28,0,-28
4203,1,0,38,0,-38
4204,1,1,2518,1493,-1025
4205,1,1,493,5391,4898
4206,1,0,73,0,-73
4207,0,0,41,0,-41
4208,0,0,12,0,-12
4209,1,1,238,1304,1066
4210,0,0,37,0,-37
4211,0,0,42,0,-42
4212,0,0,3,0,-3
4213,0,0,12,0,-12
4214,1,0,28,0,-28
4215,1,0,156,0,-156
4216,0,0,46,0,-46
4217,1,0,37,0,-37
4218,1,1,144,1228,1084
4219,1,0,0,0,0
4220,1,1,736,2327,1591
4221,1,1,700,1885,1185
4222,1,0,19,0,-19
4223,0,0,20,0,-20
4224,1,1,578,2225,1647
4225,1,0,9,0,-9
4226,0,0,27,0,-27
4227,0,0,15,0,-15
4228,1,0,19,0,-19
4229,0,0,41,0,-41
4230,1,1,1050,1852,802
4231,0,0,103,0,-103
4232,0,0,148,0,-148
4233,1,1,278,1669,1391
4234,0,0,53,0,-53
4235,0,0,39,0,-39
4236,0,0,10,0,-10
4237,1,0,32,0,-32
4238,1,1,300,1746,1446
4239,0,0,4,0,-4
4240,1,0,35,0,-35
4241,1,0,74,0,-74
4242,1,1,233,1595,1362
4243,0,0,102,0,-102
4244,1,1,156,1206,1050
4245,0,0,4,0,-4
4246,1,0,32,0,-32
4247,0,0,19,0,-19
4248,0,0,16,0,-16
4249,0,0,37,0,-37
4250,0,0,17,0,-17
4251,1,0,149,0,-149
4252,1,1,722,1584,862
4253,1,1,508,1213,705
4254,1,0,22,0,-22
4255,0,0,7,0,-7
4256,0,0,34,0,-34
4257,1,1,499,1584,1085
4258,0,0,19,0,-19
4259,0,0,47,0,-47
4260,0,0,77,0,-77
4261,0,0,12,0,-12
4262,0,0,45,0,-45
4263,0,0,102,0,-102
4264,1,0,0,0,0
4265,1,1,148,1311,1163
4266,0,0,24,0,-24
4267,0,0,33,0,-33
4268,0,0,76,0,-76
4269,1,0,144,0,-144
4270,1,0,87,0,-87
4271,0,0,26,0,-26
4272,0,0,130,0,-130
4273,1,0,26,0,-26
4274,1,0,55,0,-55
4275,1,1,1251,3573,2322
4276,1,1,1220,1419,199
4277,1,0,286,0,-286
4278,1,0,29,0,-29
4279,1,1,253,1560,1307
4280,1,1,520,1261,741
4281,1,0,147,0,-147
4282,1,0,3,0,-3
4283,1,1,2590,1355,-1235
4284,1,0,39,0,-39
4285,0,0,17,0,-17
4286,0,0,59,0,-59
4287,1,1,846,1274,428
4288,1,1,102,1227,1125
4289,1,1,373,1317,944
4290,0,0,20,0,-20
4291,0,0,19,0,-19
4292,1,0,22,0,-22
4293,1,1,293,1206,913
4294,0,0,26,0,-26
4295,0,0,54,0,-54
4296,0,0,15,0,-15
4297,1,0,39,0,-39
4298,0,0,64,0,-64
4299,0,0,21,0,-21
4300,0,0,31,0,-31
4301,0,0,1,0,-1
4302,0,0,43,0,-43
4303,0,0,2,0,-2
4304,0,0,16,0,-16
4305,0,0,16,0,-16
4306,1,0,4,0,-4
4307,0,0,0,0,0
4308,1,1,102,1849,1747
4309,1,1,539,1348,809
4310,1,0,82,0,-82
4311,0,0,43,0,-43
4312,1,1,2250,1622,-628
4313,1,0,0,0,0
4314,1,0,28,0,-28
4315,0,0,1,0,-1
4316,1,0,56,0,-56
4317,0,0,55,0,-55
4318,0,0,75,0,-75
4319,1,1,150,1414,1264
4320,1,1,139,2349,2210
4321,0,0,10,0,-10
4322,0,0,74,0,-74
4323,1,1,310,2637,2327
4324,1,0,26,0,-26
4325,0,0,66,0,-66
4326,1,0,5,0,-5
4327,0,0,21,0,-21
4328,0,0,21,0,-21
4329,1,1,1564,1715,151
4330,0,0,30,0,-30
4331,1,1,364,1807,1443
4332,1,0,107,0,-107
4333,0,0,61,0,-61
4334,1,1,1245,1209,-36
4335,1,0,31,0,-31
4336,0,0,14,0,-14
4337,1,0,41,0,-41
4338,0,0,66,0,-66
4339,0,0,0,0,0
4340,1,0,140,0,-140
4341,1,0,93,0,-93
4342,0,0,55,0,-55
4343,1,1,975,1210,235
4344,1,1,1031,1294,263
4345,1,1,1142,1647,505
4346,1,0,40,0,-40
4347,1,0,7,0,-7
4348,0,0,82,0,-82
4349,0,0,32,0,-32
4350,1,1,564,2885,2321
4351,1,0,204,0,-204
4352,0,0,26,0,-26
4353,0,0,55,0,-55
4354,1,0,92,0,-92
4355,0,0,128,0,-128
4356,1,0,7,0,-7
4357,1,1,254,1728,1474
4358,1,0,99,0,-99
4359,0,0,82,0,-82
4360,1,1,3555,1731,-1824
4361,0,0,17,0,-17
4362,1,1,139,1261,1122
4363,0,0,2,0,-2
4364,0,0,47,0,-47
4365,1,1,91,1216,1125
4366,1,0,12,0,-12
4367,1,0,6,0,-6
4368,1,0,48,0,-48
4369,0,0,2,0,-2
4370,0,0,141,0,-141
4371,1,1,77,1292,1215
4372,0,0,23,0,-23
4373,0,0,6,0,-6
4374,1,0,21,0,-21
4375,0,0,219,0,-219
4376,1,1,629,1330,701
4377,1,0,142,0,-142
4378,0,0,66,0,-66
4379,1,0,125,0,-125
4380,0,0,21,0,-21
4381,1,1,419,1383,964
4382,1,1,385,1206,821
4383,1,1,1214,1202,-12
4384,0,0,4,0,-4
4385,1,0,49,0,-49
4386,1,0,77,0,-77
4387,1,1,279,1637,1358
4388,1,0,82,0,-82
4389,0,0,11,0,-11
4390,1,0,5,0,-5
4391,0,0,18,0,-18
4392,1,0,14,0,-14
4393,1,1,677,1283,606
4394,1,1,42,1387,1345
4395,1,1,20,1523,1503
4396,1,1,176,1261,1085
4397,0,0,67,0,-67
4398,1,0,56,0,-56
4399,1,1,211,3616,3405
4400,0,0,38,0,-38
4401,1,1,74,1517,1443
4402,1,0,52,0,-52
4403,0,0,117,0,-117
4404,0,0,29,0,-29
4405,0,0,5,0,-5
4406,0,0,130,0,-130
4407,1,0,103,0,-103
4408,1,1,412,1860,1448
4409,0,0,127,0,-127
4410,1,1,681,2030,1349
4411,0,0,108,0,-108
4412,1,0,28,0,-28
4413,1,0,29,0,-29
4414,1,0,24,0,-24
4415,1,0,10,0,-10
4416,0,0,244,0,-244
4417,1,1,245,1244,999
4418,1,1,324,2042,1718
4419,1,1,42,1210,1168
4420,1,0,51,0,-51
4421,1,1,56,1276,1220
4422,0,0,55,0,-55
4423,1,1,376,1394,1018
4424,1,0,6,0,-6
4425,0,0,9,0,-9
4426,1,0,91,0,-91
4427,1,0,5,0,-5
4428,1,1,37,1304,1267
4429,0,0,8,0,-8
4430,0,0,173,0,-173
4431,1,1,1085,1285,200
4432,1,0,28,0,-28
4433,1,0,8,0,-8
4434,1,0,54,0,-54
4435,0,0,130,0,-130
4436,1,1,1470,1931,461
4437,1,1,85,1209,1124
4438,0,0,17,0,-17
4439,1,0,149,0,-149
4440,1,0,2,0,-2
4441,1,1,1043,1200,157
4442,0,0,0,0,0
4443,1,1,2641,1259,-1382
4444,0,0,47,0,-47
4445,1,1,1250,1401,151
4446,0,0,89,0,-89
4447,1,0,1,0,-1
4448,0,0,19,0,-19
4449,1,0,16,0,-16
4450,0,0,360,0,-360
4451,0,0,10,0,-10
4452,1,1,125,1351,1226
4453,1,0,2,0,-2
4454,1,1,472,1326,854
4455,0,0,7,0,-7
4456,0,0,16,0,-16
4457,0,0,34,0,-34
4458,1,1,354,1215,861
4459,1,0,40,0,-40
4460,1,0,4,0,-4
4461,1,0,102,0,-102
4462,1,0,20,0,-20
4463,1,1,2076,2022,-54
4464,0,0,333,0,-333
4465,1,0,32,0,-32
4466,0,0,12,0,-12
4467,1,0,13,0,-13
4468,0,0,91,0,-91
4469,1,1,459,1450,991
4470,1,0,121,0,-121
4471,0,0,154,0,-154
4472,1,0,87,0,-87
4473,0,0,81,0,-81
4474,0,0,29,0,-29
4475,1,1,275,1582,1307
4476,0,0,69,0,-69
4477,1,0,69,0,-69
4478,1,1,150,1699,1549
4479,1,1,602,1246,644
4480,1,0,34,0,-34
4481,0,0,117,0,-117
4482,1,0,11,0,-11
4483,0,0,112,0,-112
4484,0,0,17,0,-17
4485,0,0,58,0,-58
4486,0,0,126,0,-126
4487,1,1,1857,1690,-167
4488,1,0,114,0,-114
4489,1,1,852,1955,1103
4490,0,0,130,0,-130
4491,1,0,5,0,-5
4492,1,1,60,1292,1232
4493,1,1,225,1818,1593
4494,1,1,1314,1263,-51
4495,1,0,62,0,-62
4496,1,0,121,0,-121
4497,1,1,195,1302,1107
4498,0,0,39,0,-39
4499,0,0,76,0,-76
4500,0,0,33,0,-33
4501,1,1,730,1309,579
4502,0,0,32,0,-32
4503,0,0,1,0,-1
4504,1,1,460,1471,1011
4505,1,0,9,0,-9
4506,0,0,154,0,-154
4507,1,0,39,0,-39
4508,1,1,390,1480,1090
4509,1,0,30,0,-30
4510,0,0,55,0,-55
4511,0,0,57,0,-57
4512,0,0,160,0,-160
4513,1,1,426,1604,1178
4514,1,1,678,1377,699
4515,1,0,30,0,-30
4516,1,0,33,0,-33
4517,1,0,161,0,-161
4518,1,1,208,1355,1147
4519,1,0,59,0,-59
4520,0,0,39,0,-39
4521,1,0,11,0,-11
4522,0,0,41,0,-41
4523,1,1,100,1348,1248
4524,0,0,16,0,-16
4525,0,0,61,0,-61
4526,1,1,93,1565,1472
4527,0,0,3,0,-3
4528,0,0,114,0,-114
4529,1,0,122,0,-122
4530,0,0,91,0,-91
4531,1,1,700,1316,616
4532,1,1,204,1734,1530
4533,1,1,466,1358,892
4534,1,0,78,0,-78
4535,1,1,147,1241,1094
4536,1,0,98,0,-98
4537,0,0,24,0,-24
4538,1,0,10,0,-10
4539,0,0,21,0,-21
4540,1,1,968,1229,261
4541,1,1,874,2757,1883
4542,0,0,3,0,-3
4543,0,0,13,0,-13
4544,0,0,42,0,-42
4545,0,0,51,0,-51
4546,0,0,38,0,-38
4547,1,1,132,1213,1081
4548,1,1,995,1524,529
4549,0,0,11,0,-11
4550,0,0,104,0,-104
4551,0,0,19,0,-19
4552,1,0,14,0,-14
4553,1,0,50,0,-50
4554,0,0,26,0,-26
4555,0,0,16,0,-16
4556,1,0,4,0,-4
4557,1,1,153,1514,1361
4558,1,1,362,2202,1840
4559,1,1,338,1585,1247
4560,1,0,69,0,-69
4561,0,0,44,0,-44
4562,0,0,33,0,-33
4563,0,0,39,0,-39
4564,1,1,463,1223,760
4565,0,0,7,0,-7
4566,0,0,28,0,-28
4567,0,0,17,0,-17
4568,1,1,371,1507,1136
4569,1,0,16,0,-16
4570,0,0,48,0,-48
4571,0,0,31,0,-31
4572,1,0,32,0,-32
4573,1,1,414,1209,795
4574,1,0,52,0,-52
4575,0,0,168,0,-168
4576,0,0,29,0,-29
4577,1,0,104,0,-104
4578,0,0,22,0,-22
4579,1,0,10,0,-10
4580,0,0,1,0,-1
4581,0,0,22,0,-22
4582,1,0,12,0,-12
4583,1,1,718,1501,783
4584,1,0,156,0,-156
4585,0,0,61,0,-61
4586,0,0,22,0,-22
4587,1,1,311,2740,2429
4588,0,0,64,0,-64
4589,1,1,675,1662,987
4590,0,0,159,0,-159
4591,1,1,481,1415,934
4592,1,0,1,0,-1
4593,0,0,83,0,-83
4594,1,1,575,3286,2711
4595,1,0,12,0,-12
4596,1,1,382,1239,857
4597,0,0,5,0,-5
4598,0,0,30,0,-30
4599,1,1,860,1246,386
4600,1,1,122,1898,1776
4601,0,0,103,0,-103
4602,0,0,108,0,-108
4603,1,0,20,0,-20
4604,1,0,61,0,-61
4605,1,1,272,2571,2299
4606,1,1,101,1802,1701
4607,0,0,6,0,-6
4608,1,1,313,1273,960
4609,0,0,43,0,-43
4610,0,0,14,0,-14
4611,1,0,32,0,-32
4612,0,0,86,0,-86
4613,1,1,302,3947,3645
4614,1,0,47,0,-47
4615,1,1,180,1606,1426
4616,0,0,92,0,-92
4617,1,1,881,1650,769
4618,0,0,29,0,-29
4619,1,1,621,1720,1099
4620,0,0,47,0,-47
4621,1,1,211,1328,1117
4622,1,1,1134,1491,357
4623,0,0,59,0,-59
4624,0,0,5,0,-5
4625,1,0,62,0,-62
4626,1,0,24,0,-24
4627,1,0,230,0,-230
4628,0,0,68,0,-68
4629,1,0,16,0,-16
4630,1,0,24,0,-24
4631,1,0,49,0,-49
4632,1,1,718,1262,544
4633,1,1,111,1318,1207
4634,1,0,75,0,-75
4635,1,0,12,0,-12
4636,1,0,94,0,-94
4637,1,0,31,0,-31
4638,1,1,232,1369,1137
4639,0,0,13,0,-13
4640,0,0,20,0,-20
4641,0,0,31,0,-31
4642,1,0,30,0,-30
4643,0,0,3,0,-3
4644,0,0,70,0,-70
4645,1,1,224,2446,2222
4646,1,0,13,0,-13
4647,1,1,321,1308,987
4648,1,1,1707,2021,314
4649,1,1,945,1722,777
4650,0,0,108,0,-108
4651,0,0,10,0,-10
4652,0,0,1,0,-1
4653,0,0,94,0,-94
4654,1,1,1526,1991,465
4655,0,0,0,0,0
4656,1,1,493,1448,955
4657,0,0,9,0,-9
4658,1,1,329,1237,908
4659,1,1,351,1240,889
4660,0,0,34,0,-34
4661,1,1,427,1299,872
4662,1,1,467,1426,959
4663,1,0,141,0,-141
4664,0,0,1,0,-1
4665,1,0,63,0,-63
4666,1,1,584,1520,936
4667,0,0,64,0,-64
4668,0,0,18,0,-18
4669,1,0,84,0,-84
4670,0,0,84,0,-84
4671,1,0,35,0,-35
4672,1,0,97,0,-97
4673,1,1,131,1324,1193
4674,0,0,21,0,-21
4675,1,1,108,1244,1136
4676,1,0,29,0,-29
4677,1,1,559,1679,1120
4678,0,0,142,0,-142
4679,0,0,56,0,-56
4680,1,0,96,0,-96
4681,0,0,31,0,-31
4682,1,1,447,2462,2015
4683,0,0,18,0,-18
4684,1,1,191,1269,1078
4685,1,1,149,1362,1213
4686,0,0,14,0,-14
4687,1,0,45,0,-45
4688,1,0,253,0,-253
4689,1,1,373,1358,985
4690,0,0,58,0,-58
4691,0,0,114,0,-114
4692,1,1,23,1205,1182
4693,1,0,20,0,-20
4694,1,1,1825,1589,-236
4695,0,0,65,0,-65
4696,0,0,74,0,-74
4697,1,0,7,0,-7
4698,1,1,315,1948,1633
4699,1,1,1172,1293,121
4700,1,0,80,0,-80
4701,0,0,138,0,-138
4702,1,0,10,0,-10
4703,0,0,2,0,-2
4704,1,0,25,0,-25
4705,0,0,2,0,-2
4706,1,0,74,0,-74
4707,1,1,165,1250,1085
4708,0,0,2,0,-2
4709,1,0,8,0,-8
4710,1,0,43,0,-43
4711,1,1,194,1248,1054
4712,1,1,140,1224,1084
4713,0,0,2,0,-2
4714,0,0,8,0,-8
4715,1,1,641,1431,790
4716,0,0,122,0,-122
4717,0,0,113,0,-113
4718,0,0,31,0,-31
4719,1,0,37,0,-37
4720,1,1,1685,1243,-442
4721,1,1,49,2202,2153
4722,0,0,3,0,-3
4723,0,0,117,0,-117
4724,0,0,20,0,-20
4725,0,0,10,0,-10
4726,0,0,81,0,-81
4727,1,1,422,1377,955
4728,1,0,49,0,-49
4729,0,0,96,0,-96
4730,0,0,87,0,-87
4731,1,1,402,1526,1124
4732,1,0,49,0,-49
4733,0,0,20,0,-20
4734,1,1,156,2179,2023
4735,0,0,152,0,-152
4736,1,1,1582,1252,-330
4737,0,0,7,0,-7
4738,1,1,292,1245,953
4739,1,0,121,0,-121
4740,1,0,74,0,-74
4741,1,1,56,1279,1223
4742,1,1,193,1239,1046
4743,0,0,1,0,-1
4744,1,1,88,1241,1153
4745,1,0,201,0,-201
4746,1,0,47,0,-47
4747,1,0,126,0,-126
4748,0,0,8,0,-8
4749,0,0,19,0,-19
4750,1,1,3313,1370,-1943
4751,0,0,135,0,-135
4752,1,1,44,1368,1324
4753,0,0,23,0,-23
4754,1,0,83,0,-83
4755,1,1,740,1408,668
4756,0,0,11,0,-11
4757,1,1,38,1297,1259
4758,1,0,37,0,-37
4759,1,1,607,1319,712
4760,1,1,263,1370,1107
4761,0,0,118,0,-118
4762,0,0,14,0,-14
4763,0,0,57,0,-57
4764,0,0,77,0,-77
4765,0,0,23,0,-23
4766,1,0,60,0,-60
4767,1,1,141,1507,1366
4768,1,1,848,1860,1012
4769,0,0,23,0,-23
4770,0,0,60,0,-60
4771,1,0,113,0,-113
4772,0,0,19,0,-19
4773,1,0,33,0,-33
4774,0,0,2,0,-2
4775,1,1,174,2303,2129
4776,1,0,6,0,-6
4777,1,0,59,0,-59
4778,0,0,40,0,-40
4779,1,0,10,0,-10
4780,0,0,101,0,-101
4781,0,0,120,0,-120
4782,0,0,30,0,-30
4783,1,0,24,0,-24
4784,1,1,139,2034,1895
4785,1,1,90,1401,1311
4786,0,0,77,0,-77
4787,1,0,10,0,-10
4788,1,0,18,0,-18
4789,1,1,910,1261,351
4790,1,1,527,1837,1310
4791,1,1,1349,3481,2132
4792,1,1,178,1521,1343
4793,1,1,368,2847,2479
4794,0,0,44,0,-44
4795,1,1,986,1722,736
4796,1,1,351,1375,1024
4797,0,0,35,0,-35
4798,0,0,29,0,-29
4799,0,0,49,0,-49
4800,1,1,145,1572,1427
4801,0,0,13,0,-13
4802,0,0,129,0,-129
4803,1,1,576,1345,769
4804,1,1,307,1262,955
4805,1,0,108,0,-108
4806,0,0,28,0,-28
4807,0,0,28,0,-28
4808,1,0,29,0,-29
4809,0,0,29,0,-29
4810,1,0,46,0,-46
4811,0,0,46,0,-46
4812,0,0,47,0,-47
4813,0,0,45,0,-45
4814,0,0,57,0,-57
4815,1,0,34,0,-34
4816,1,1,157,1309,1152
4817,0,0,47,0,-47
4818,0,0,276,0,-276
4819,0,0,1,0,-1
4820,1,0,68,0,-68
4821,1,1,251,1444,1193
4822,0,0,99,0,-99
4823,0,0,7,0,-7
4824,1,0,47,0,-47
4825,0,0,4,0,-4
4826,1,0,12,0,-12
4827,1,1,178,1321,1143
4828,0,0,28,0,-28
4829,0,0,26,0,-26
4830,1,0,19,0,-19
4831,1,0,148,0,-148
4832,0,0,1,0,-1
4833,1,1,180,1465,1285
4834,1,1,170,1337,1167
4835,0,0,13,0,-13
4836,1,0,247,0,-247
4837,1,1,254,1409,1155
4838,1,1,896,1319,423
4839,1,1,332,1241,909
4840,1,1,320,1231,911
4841,1,0,58,0,-58
4842,0,0,71,0,-71
4843,0,0,24,0,-24
4844,0,0,68,0,-68
4845,1,1,470,1360,890
4846,0,0,16,0,-16
4847,1,1,87,1622,1535
4848,0,0,55,0,-55
4849,1,1,333,1623,1290
4850,1,1,1148,1403,255
4851,1,0,9,0,-9
4852,0,0,30,0,-30
4853,0,0,4,0,-4
4854,1,1,236,1604,1368
4855,1,1,361,1304,943
4856,1,0,140,0,-140
4857,0,0,236,0,-236
4858,1,0,66,0,-66
4859,1,1,493,2115,1622
4860,1,0,46,0,-46
4861,1,0,27,0,-27
4862,0,0,76,0,-76
4863,0,0,56,0,-56
4864,1,1,281,1455,1174
4865,0,0,13,0,-13
4866,1,1,360,1323,963
4867,0,0,33,0,-33
4868,0,0,118,0,-118
4869,1,1,936,1382,446
4870,0,0,7,0,-7
4871,1,0,14,0,-14
4872,1,1,260,1306,1046
4873,1,0,19,0,-19
4874,0,0,32,0,-32
4875,1,1,260,1654,1394
4876,1,0,60,0,-60
4877,0,0,43,0,-43
4878,0,0,13,0,-13
4879,0,0,102,0,-102
4880,1,1,726,1858,1132
4881,1,1,285,1812,1527
4882,1,0,37,0,-37
4883,1,0,13,0,-13
4884,0,0,3,0,-3
4885,0,0,78,0,-78
4886,0,0,65,0,-65
4887,1,0,36,0,-36
4888,1,1,501,1307,806
4889,1,0,120,0,-120
4890,0,0,20,0,-20
4891,1,0,77,0,-77
4892,0,0,45,0,-45
4893,1,1,583,1283,700
4894,1,0,46,0,-46
4895,1,1,418,1444,1026
4896,1,1,378,1305,927
4897,1,0,14,0,-14
4898,1,0,52,0,-52
4899,1,0,58,0,-58
4900,0,0,19,0,-19
4901,1,0,12,0,-12
4902,0,0,19,0,-19
4903,1,0,4,0,-4
4904,1,1,736,2060,1324
4905,0,0,5,0,-5
4906,0,0,14,0,-14
4907,1,1,231,2177,1946
4908,1,1,273,2380,2107
4909,1,1,686,1503,817
4910,1,0,19,0,-19
4911,1,0,130,0,-130
4912,0,0,15,0,-15
4913,0,0,13,0,-13
4914,0,0,134,0,-134
4915,1,0,48,0,-48
4916,1,1,791,1503,712
4917,0,0,98,0,-98
4918,1,1,242,1632,1390
4919,0,0,44,0,-44
4920,1,0,16,0,-16
4921,0,0,11,0,-11
4922,1,0,11,0,-11
4923,1,1,401,1350,949
4924,1,1,925,1346,421
4925,1,0,8,0,-8
4926,1,0,84,0,-84
4927,0,0,18,0,-18
4928,1,0,44,0,-44
4929,1,1,275,1473,1198
4930,1,1,223,1360,1137
4931,1,1,203,3252,3049
4932,1,1,142,1396,1254
4933,0,0,128,0,-128
4934,1,1,110,1643,1533
4935,1,0,20,0,-20
4936,1,0,7,0,-7
4937,1,1,454,2085,1631
4938,1,1,776,1473,697
4939,1,1,84,1880,1796
4940,1,1,81,1229,1148
4941,0,0,56,0,-56
4942,1,0,41,0,-41
4943,0,0,57,0,-57
4944,1,0,68,0,-68
4945,0,0,5,0,-5
4946,1,0,83,0,-83
4947,1,1,643,1691,1048
4948,1,1,539,1608,1069
4949,0,0,2,0,-2
4950,1,1,101,1213,1112
4951,0,0,3,0,-3
4952,0,0,12,0,-12
4953,1,1,65,1267,1202
4954,1,1,44,1479,1435
4955,0,0,23,0,-23
4956,1,0,95,0,-95
4957,0,0,0,0,0
4958,1,0,19,0,-19
4959,1,1,1601,1496,-105
4960,1,1,1036,1224,188
4961,1,1,887,1409,522
4962,0,0,30,0,-30
4963,0,0,29,0,-29
4964,1,1,1193,1251,58
4965,0,0,69,0,-69
4966,0,0,3,0,-3
4967,0,0,57,0,-57
4968,1,0,34,0,-34
4969,0,0,10,0,-10
4970,1,1,31,1641,1610
4971,0,0,3,0,-3
4972,0,0,10,0,-10
4973,1,1,427,1338,911
4974,0,0,41,0,-41
4975,1,1,595,1612,1017
4976,0,0,57,0,-57
4977,0,0,12,0,-12
4978,1,1,679,1325,646
4979,1,1,235,1266,1031
4980,1,0,4,0,-4
4981,1,1,237,1332,1095
4982,1,1,228,2403,2175
4983,1,0,4,0,-4
4984,1,0,142,0,-142
4985,1,1,64,1291,1227
4986,0,0,69,0,-69
4987,1,0,205,0,-205
4988,0,0,199,0,-199
4989,1,0,0,0,0
4990,1,0,15,0,-15
4991,0,0,77,0,-77
4992,1,0,0,0,0
4993,1,0,49,0,-49
4994,1,0,74,0,-74
4995,1,1,199,1300,1101
4996,1,0,111,0,-111
4997,0,0,7,0,-7
4998,1,0,20,0,-20
4999,0,0,24,0,-24
5000,0,0,0,0,0
5001,0,0,36,0,-36
5002,0,0,12,0,-12
5003,0,0,38,0,-38
5004,1,1,1026,1350,324
5005,1,1,728,1767,1039
5006,1,1,200,1219,1019
5007,1,1,520,1629,1109
5008,1,0,63,0,-63
5009,1,1,1295,1738,443
5010,0,0,13,0,-13
5011,1,1,728,1278,550
5012,1,1,988,1502,514
5013,1,0,21,0,-21
5014,1,1,581,1394,813
5015,0,0,13,0,-13
5016,0,0,26,0,-26
5017,1,1,813,1467,654
5018,1,1,417,1864,1447
5019,1,0,24,0,-24
5020,1,0,96,0,-96
5021,0,0,32,0,-32
5022,0,0,19,0,-19
5023,0,0,49,0,-49
5024,1,0,32,0,-32
5025,0,0,28,0,-28
5026,1,0,21,0,-21
5027,0,0,53,0,-53
5028,1,1,117,1206,1089
5029,0,0,53,0,-53
5030,1,0,2,0,-2
5031,1,1,374,1324,950
5032,1,1,81,1702,1621
5033,0,0,9,0,-9
5034,0,0,23,0,-23
5035,1,0,8,0,-8
5036,1,0,4,0,-4
5037,1,0,25,0,-25
5038,1,0,9,0,-9
5039,1,1,325,1492,1167
5040,0,0,31,0,-31
5041,1,0,30,0,-30
5042,0,0,4,0,-4
5043,0,0,162,0,-162
5044,0,0,92,0,-92
5045,0,0,85,0,-85
5046,1,1,60,1221,1161
5047,1,1,852,1528,676
5048,1,1,156,1449,1293
5049,1,0,51,0,-51
5050,1,0,80,0,-80
5051,1,1,729,2031,1302
5052,0,0,109,0,-109
5053,1,1,1958,1376,-582
5054,1,0,68,0,-68
5055,1,1,662,1418,756
5056,0,0,13,0,-13
5057,0,0,79,0,-79
5058,1,1,759,1280,521
5059,0,0,27,0,-27
5060,1,1,937,1502,565
5061,1,1,360,1633,1273
5062,1,1,1803,1959,156
5063,1,1,570,1410,840
5064,1,1,1369,1459,90
5065,1,1,1284,1524,240
5066,0,0,44,0,-44
5067,0,0,20,0,-20
5068,0,0,30,0,-30
5069,1,1,528,2339,1811
5070,1,1,389,1403,1014
5071,1,0,17,0,-17
5072,0,0,36,0,-36
5073,0,0,22,0,-22
5074,1,0,154,0,-154
5075,0,0,102,0,-102
5076,0,0,84,0,-84
5077,1,1,151,1683,1532
5078,1,0,10,0,-10
5079,0,0,59,0,-59
5080,0,0,56,0,-56
5081,1,0,187,0,-187
5082,0,0,6,0,-6
5083,1,1,494,1719,1225
5084,1,0,37,0,-37
5085,1,0,1,0,-1
5086,1,0,277,0,-277
5087,1,1,596,1908,1312
5088,1,1,212,2054,1842
5089,1,1,1443,1970,527
5090,0,0,37,0,-37
5091,1,0,25,0,-25
5092,1,0,27,0,-27
5093,1,1,322,1346,1024
5094,1,1,316,1219,903
5095,1,0,2,0,-2
5096,1,0,89,0,-89
5097,1,1,309,1506,1197
5098,1,0,15,0,-15
5099,1,0,3,0,-3
5100,0,0,228,0,-228
5101,0,0,2,0,-2
5102,1,1,1536,1495,-41
5103,1,0,102,0,-102
5104,1,1,131,1661,1530
5105,1,1,1665,1496,-169
5106,0,0,19,0,-19
5107,0,0,64,0,-64
5108,0,0,155,0,-155
5109,1,0,90,0,-90
5110,1,1,403,2141,1738
5111,1,0,41,0,-41
5112,0,0,62,0,-62
5113,0,0,20,0,-20
5114,0,0,322,0,-322
5115,1,1,253,1633,1380
5116,0,0,137,0,-137
5117,1,1,178,1237,1059
5118,1,0,14,0,-14
5119,1,1,43,1301,1258
5120,1,0,7,0,-7
5121,0,0,72,0,-72
5122,1,0,17,0,-17
5123,1,1,495,1581,1086
5124,1,0,79,0,-79
5125,1,1,379,2168,1789
5126,1,1,95,1251,1156
5127,0,0,22,0,-22
5128,0,0,71,0,-71
5129,0,0,92,0,-92
5130,0,0,3,0,-3
5131,1,1,80,1379,1299
5132,0,0,26,0,-26
5133,1,1,16,1507,1491
5134,1,0,19,0,-19
5135,1,1,227,1264,1037
5136,1,0,70,0,-70
5137,1,0,16,0,-16
5138,0,0,68,0,-68
5139,1,0,74,0,-74
5140,1,1,280,2151,1871
5141,1,0,32,0,-32
5142,1,0,26,0,-26
5143,0,0,13,0,-13
5144,0,0,136,0,-136
5145,1,0,98,0,-98
5146,1,0,25,0,-25
5147,1,1,827,1206,379
5148,1,1,165,1651,1486
5149,0,0,132,0,-132
5150,0,0,13,0,-13
5151,1,0,51,0,-51
5152,1,0,19,0,-19
5153,1,0,25,0,-25
5154,0,0,41,0,-41
5155,0,0,59,0,-59
5156,1,0,41,0,-41
5157,1,1,67,1940,1873
5158,1,1,1107,3559,2452
5159,0,0,15,0,-15
5160,0,0,32,0,-32
5161,1,1,935,1352,417
5162,1,1,338,1493,1155
5163,0,0,93,0,-93
5164,0,0,54,0,-54
5165,1,1,541,1215,674
5166,0,0,67,0,-67
5167,1,1,422,1900,1478
5168,1,0,18,0,-18
5169,1,0,22,0,-22
5170,1,0,67,0,-67
5171,1,1,120,1585,1465
5172,1,0,30,0,-30
5173,0,0,31,0,-31
5174,1,0,5,0,-5
5175,1,1,1117,1227,110
5176,1,0,63,0,-63
5177,0,0,93,0,-93
5178,1,1,310,1234,924
5179,1,1,152,2075,1923
5180,1,1,148,2565,2417
5181,1,1,368,1349,981
5182,1,1,149,1437,1288
5183,0,0,7,0,-7
5184,1,0,12,0,-12
5185,1,0,8,0,-8
5186,1,0,8,0,-8
5187,0,0,0,0,0
5188,1,0,20,0,-20
5189,0,0,21,0,-21
5190,1,0,7,0,-7
5191,0,0,94,0,-94
5192,0,0,33,0,-33
5193,1,0,64,0,-64
5194,1,1,265,1416,1151
5195,0,0,18,0,-18
5196,1,1,1734,1823,89
5197,1,0,2,0,-2
5198,0,0,26,0,-26
5199,1,1,1013,1629,616
5200,1,0,23,0,-23
5201,0,0,15,0,-15
5202,1,0,1,0,-1
5203,0,0,28,0,-28
5204,1,0,7,0,-7
5205,0,0,23,0,-23
5206,0,0,172,0,-172
5207,1,1,647,1257,610
5208,0,0,13,0,-13
5209,0,0,14,0,-14
5210,1,0,11,0,-11
5211,1,1,679,1360,681
5212,1,0,13,0,-13
5213,1,1,34,1912,1878
5214,0,0,7,0,-7
5215,0,0,171,0,-171
5216,0,0,142,0,-142
5217,0,0,9,0,-9
5218,0,0,56,0,-56
5219,1,0,2,0,-2
5220,1,0,6,0,-6
5221,1,1,335,1265,930
5222,1,1,127,1562,1435
5223,0,0,169,0,-169
5224,1,1,58,1571,1513
5225,0,0,1,0,-1
5226,0,0,139,0,-139
5227,0,0,27,0,-27
5228,0,0,49,0,-49
5229,1,0,0,0,0
5230,1,0,32,0,-32
5231,0,0,153,0,-153
5232,0,0,7,0,-7
5233,0,0,2,0,-2
5234,1,1,1652,1213,-439
5235,1,0,13,0,-13
5236,1,0,33,0,-33
5237,1,0,34,0,-34
5238,1,0,24,0,-24
5239,1,0,73,0,-73
5240,0,0,90,0,-90
5241,1,0,0,0,0
5242,1,1,269,1512,1243
5243,0,0,7,0,-7
5244,1,0,21,0,-21
5245,1,0,6,0,-6
5246,1,1,360,1332,972
5247,1,0,59,0,-59
5248,1,1,283,1331,1048
5249,0,0,19,0,-19
5250,0,0,2,0,-2
5251,1,1,239,2120,1881
5252,0,0,77,0,-77
5253,1,1,310,1666,1356
5254,1,1,951,1732,781
5255,1,1,280,1538,1258
5256,1,0,23,0,-23
5257,1,0,38,0,-38
5258,1,0,48,0,-48
5259,0,0,219,0,-219
5260,0,0,8,0,-8
5261,1,1,1028,1927,899
5262,1,1,332,1374,1042
5263,1,1,823,1361,538
5264,1,1,561,1737,1176
5265,1,1,251,1481,1230
5266,0,0,20,0,-20
5267,1,0,104,0,-104
5268,1,0,25,0,-25
5269,0,0,1,0,-1
5270,0,0,84,0,-84
5271,0,0,40,0,-40
5272,0,0,35,0,-35
5273,0,0,51,0,-51
5274,1,0,26,0,-26
5275,1,0,47,0,-47
5276,1,1,246,2694,2448
5277,0,0,32,0,-32
5278,1,0,112,0,-112
5279,1,1,261,1803,1542
5280,1,0,4,0,-4
5281,0,0,15,0,-15
5282,0,0,35,0,-35
5283,1,0,31,0,-31
5284,1,0,73,0,-73
5285,1,0,81,0,-81
5286,1,1,291,1254,963
5287,0,0,103,0,-103
5288,1,1,404,1257,853
5289,1,0,34,0,-34
5290,0,0,13,0,-13
5291,1,1,552,1572,1020
5292,0,0,104,0,-104
5293,1,0,17,0,-17
5294,1,1,1087,1545,458
5295,0,0,29,0,-29
5296,0,0,175,0,-175
5297,0,0,8,0,-8
5298,1,1,175,1920,1745
5299,1,0,43,0,-43
5300,1,1,1021,1294,273
5301,1,0,64,0,-64
5302,1,1,2959,2057,-902
5303,1,0,12,0,-12
5304,1,0,0,0,0
5305,1,1,523,1215,692
5306,1,0,100,0,-100
5307,1,0,10,0,-10
5308,0,0,20,0,-20
5309,1,0,15,0,-15
5310,0,0,84,0,-84
5311,1,0,20,0,-20
5312,0,0,42,0,-42
5313,0,0,4,0,-4
5314,1,0,29,0,-29
5315,0,0,156,0,-156
5316,1,0,10,0,-10
5317,1,0,90,0,-90
5318,1,0,62,0,-62
5319,1,1,730,3152,2422
5320,1,1,452,1372,920
5321,0,0,1,0,-1
5322,0,0,88,0,-88
5323,1,1,354,1297,943
5324,0,0,67,0,-67
5325,1,1,246,1312,1066
5326,1,1,302,1411,1109
5327,1,0,118,0,-118
5328,1,1,1016,1443,427
5329,1,1,627,1235,608
5330,0,0,171,0,-171
5331,1,1,1048,1677,629
5332,0,0,82,0,-82
5333,1,0,3,0,-3
5334,1,1,256,2703,2447
5335,1,0,10,0,-10
5336,1,0,80,0,-80
5337,1,1,643,1377,734
5338,1,0,151,0,-151
5339,1,0,29,0,-29
5340,0,0,7,0,-7
5341,1,1,312,2075,1763
5342,1,1,440,1744,1304
5343,0,0,69,0,-69
5344,1,0,21,0,-21
5345,0,0,0,0,0
5346,1,1,571,1558,987
5347,1,0,92,0,-92
5348,1,1,747,1785,1038
5349,1,1,11,1219,1208
5350,1,1,554,1224,670
5351,0,0,62,0,-62
5352,1,1,140,1707,1567
5353,1,1,96,1339,1243
5354,1,1,81,1350,1269
5355,0,0,108,0,-108
5356,0,0,117,0,-117
5357,1,0,45,0,-45
5358,1,1,242,2371,2129
5359,0,0,13,0,-13
5360,1,0,38,0,-38
5361,1,0,43,0,-43
5362,1,0,146,0,-146
5363,0,0,39,0,-39
5364,1,1,581,1335,754
5365,1,0,17,0,-17
5366,1,1,202,1388,1186
5367,1,1,303,1530,1227
5368,1,1,563,1209,646
5369,0,0,166,0,-166
5370,1,1,1782,1389,-393
5371,0,0,34,0,-34
5372,0,0,30,0,-30
5373,1,1,717,1205,488
5374,0,0,29,0,-29
5375,1,0,77,0,-77
5376,1,0,2,0,-2
5377,1,0,40,0,-40
5378,1,0,37,0,-37
5379,0,0,85,0,-85
5380,0,0,10,0,-10
5381,0,0,36,0,-36
5382,1,0,26,0,-26
5383,1,0,30,0,-30
5384,1,1,182,2043,1861
5385,1,1,1559,1446,-113
5386,0,0,89,0,-89
5387,1,0,74,0,-74
5388,0,0,111,0,-111
5389,0,0,1,0,-1
5390,0,0,27,0,-27
5391,1,1,85,1427,1342
5392,0,0,34,0,-34
5393,0,0,80,0,-80
5394,1,0,23,0,-23
5395,1,0,68,0,-68
5396,0,0,45,0,-45
5397,0,0,3,0,-3
5398,0,0,56,0,-56
5399,0,0,66,0,-66
5400,1,1,288,1274,986
5401,0,0,61,0,-61
5402,1,0,24,0,-24
5403,1,1,1072,1224,152
5404,1,0,37,0,-37
5405,0,0,14,0,-14
5406,0,0,1,0,-1
5407,1,0,4,0,-4
5408,0,0,74,0,-74
5409,0,0,25,0,-25
5410,0,0,252,0,-252
5411,1,0,17,0,-17
5412,0,0,39,0,-39
5413,1,0,63,0,-63
5414,1,0,11,0,-11
5415,0,0,95,0,-95
5416,1,1,905,2215,1310
5417,1,0,18,0,-18
5418,0,0,39,0,-39
5419,1,0,115,0,-115
5420,0,0,123,0,-123
5421,0,0,31,0,-31
5422,0,0,16,0,-16
5423,1,1,941,1206,265
5424,1,1,722,1372,650
5425,1,0,50,0,-50
5426,1,1,1318,3637,2319
5427,1,0,20,0,-20
5428,1,0,65,0,-65
5429,1,0,2,0,-2
5430,1,1,527,1741,1214
5431,0,0,78,0,-78
5432,1,0,51,0,-51
5433,0,0,28,0,-28
5434,1,0,75,0,-75
5435,1,1,207,1246,1039
5436,1,0,34,0,-34
5437,1,1,1142,1268,126
5438,0,0,42,0,-42
5439,1,0,26,0,-26
5440,0,0,14,0,-14
5441,0,0,38,0,-38
5442,1,1,1060,1315,255
5443,1,1,295,1858,1563
5444,0,0,30,0,-30
5445,1,1,323,1429,1106
5446,1,1,246,1350,1104
5447,0,0,33,0,-33
5448,1,1,325,2457,2132
5449,1,1,416,1338,922
5450,1,0,50,0,-50
5451,1,0,12,0,-12
5452,1,1,339,1335,996
5453,1,1,1989,2430,441
5454,1,0,7,0,-7
5455,0,0,20,0,-20
5456,1,0,97,0,-97
5457,1,0,37,0,-37
5458,1,0,103,0,-103
5459,1,1,455,1626,1171
5460,1,1,437,1329,892
5461,1,0,45,0,-45
5462,1,0,51,0,-51
5463,1,1,156,1262,1106
5464,1,0,27,0,-27
5465,0,0,44,0,-44
5466,0,0,53,0,-53
5467,1,0,16,0,-16
5468,1,0,19,0,-19
5469,0,0,44,0,-44
5470,1,0,11,0,-11
5471,1,0,182,0,-182
5472,1,1,573,1244,671
5473,0,0,3,0,-3
5474,1,1,74,1761,1687
5475,1,1,374,1267,893
5476,0,0,177,0,-177
5477,1,1,173,1240,1067
5478,1,1,671,1297,626
5479,1,0,121,0,-121
5480,1,1,70,1401,1331
5481,1,0,4,0,-4
5482,0,0,37,0,-37
5483,0,0,21,0,-21
5484,0,0,43,0,-43
5485,0,0,2,0,-2
5486,0,0,29,0,-29
5487,1,0,7,0,-7
5488,1,1,833,1262,429
5489,1,0,26,0,-26
5490,0,0,3,0,-3
5491,1,1,1523,1208,-315
5492,0,0,14,0,-14
5493,1,0,45,0,-45
5494,1,0,17,0,-17
5495,1,1,170,1347,1177
5496,1,1,711,1593,882
5497,0,0,35,0,-35
5498,0,0,13,0,-13
5499,0,0,69,0,-69
5500,0,0,189,0,-189
5501,1,0,56,0,-56
5502,1,1,136,1767,1631
5503,0,0,137,0,-137
5504,1,0,36,0,-36
5505,1,1,406,4198,3792
5506,0,0,61,0,-61
5507,1,0,43,0,-43
5508,1,1,976,1480,504
5509,1,1,341,1245,904
5510,0,0,0,0,0
5511,1,0,102,0,-102
5512,1,0,91,0,-91
5513,0,0,2,0,-2
5514,0,0,29,0,-29
5515,0,0,20,0,-20
5516,0,0,3,0,-3
5517,1,1,201,1225,1024
5518,0,0,80,0,-80
5519,1,0,179,0,-179
5520,0,0,7,0,-7
5521,1,1,1586,1726,140
5522,1,0,56,0,-56
5523,1,0,2,0,-2
5524,1,1,186,1233,1047
5525,1,0,9,0,-9
5526,0,0,86,0,-86
5527,1,0,113,0,-113
5528,0,0,41,0,-41
5529,0,0,410,0,-410
5530,0,0,8,0,-8
5531,1,0,48,0,-48
5532,1,0,48,0,-48
5533,1,1,299,1396,1097
5534,1,0,141,0,-141
5535,0,0,70,0,-70
5536,1,0,108,0,-108
5537,0,0,55,0,-55
5538,1,1,133,1985,1852
5539,1,1,471,1424,953
5540,0,0,18,0,-18
5541,1,1,612,5688,5076
5542,1,1,1040,2051,1011
5543,1,0,32,0,-32
5544,0,0,26,0,-26
5545,0,0,19,0,-19
5546,0,0,17,0,-17
5547,1,0,32,0,-32
5548,1,1,959,1214,255
5549,0,0,1,0,-1
5550,1,0,8,0,-8
5551,1,0,18,0,-18
5552,1,1,738,1941,1203
5553,1,1,350,1763,1413
5554,1,0,23,0,-23
5555,0,0,12,0,-12
5556,0,0,75,0,-75
5557,1,1,176,1449,1273
5558,1,0,19,0,-19
5559,1,0,60,0,-60
5560,0,0,52,0,-52
5561,0,0,3,0,-3
5562,0,0,12,0,-12
5563,1,1,227,1233,1006
5564,1,1,107,1510,1403
5565,1,0,12,0,-12
5566,1,1,187,2218,2031
5567,0,0,35,0,-35
5568,0,0,38,0,-38
5569,0,0,30,0,-30
5570,1,0,10,0,-10
5571,0,0,4,0,-4
5572,0,0,68,0,-68
5573,0,0,4,0,-4
5574,0,0,34,0,-34
5575,1,0,38,0,-38
5576,1,1,933,2214,1281
5577,0,0,55,0,-55
5578,0,0,79,0,-79
5579,0,0,78,0,-78
5580,1,1,149,1745,1596
5581,1,0,61,0,-61
5582,0,0,44,0,-44
5583,0,0,92,0,-92
5584,1,0,74,0,-74
5585,1,1,83,1455,1372
5586,0,0,5,0,-5
5587,1,1,633,1494,861
5588,0,0,8,0,-8
5589,0,0,40,0,-40
5590,1,1,994,1669,675
5591,0,0,65,0,-65
5592,0,0,10,0,-10
5593,1,1,191,1395,1204
5594,0,0,60,0,-60
5595,1,1,843,1515,672
5596,0,0,4,0,-4
5597,1,1,278,1640,1362
5598,0,0,60,0,-60
5599,1,1,229,1670,1441
5600,1,1,243,4324,4081
5601,0,0,47,0,-47
5602,1,0,121,0,-121
5603,1,0,129,0,-129
5604,1,0,0,0,0
5605,0,0,2,0,-2
5606,0,0,121,0,-121
5607,1,0,9,0,-9
5608,1,1,940,4001,3061
5609,1,0,12,0,-12
5610,1,0,106,0,-106
5611,0,0,11,0,-11
5612,1,1,187,2758,2571
5613,0,0,18,0,-18
5614,1,0,19,0,-19
5615,1,1,131,1245,1114
5616,1,1,152,1260,1108
5617,1,1,269,1223,954
5618,0,0,21,0,-21
5619,1,0,75,0,-75
5620,0,0,27,0,-27
5621,1,0,48,0,-48
5622,0,0,82,0,-82
5623,1,0,41,0,-41
5624,1,1,352,2015,1663
5625,1,1,294,1455,1161
5626,1,1,395,1271,876
5627,1,0,96,0,-96
5628,1,0,3,0,-3
5629,1,0,13,0,-13
5630,0,0,11,0,-11
5631,1,1,178,1531,1353
5632,1,1,2048,1390,-658
5633,0,0,23,0,-23
5634,1,1,287,2992,2705
5635,1,0,156,0,-156
5636,1,1,1306,1234,-72
5637,1,0,26,0,-26
5638,0,0,105,0,-105
5639,0,0,166,0,-166
5640,1,0,50,0,-50
5641,1,1,28,1406,1378
5642,1,1,155,1675,1520
5643,1,1,381,1206,825
5644,0,0,7,0,-7
5645,1,0,18,0,-18
5646,1,0,42,0,-42
5647,0,0,29,0,-29
5648,1,0,118,0,-118
5649,0,0,16,0,-16
5650,1,0,4,0,-4
5651,0,0,27,0,-27
5652,0,0,97,0,-97
5653,1,0,70,0,-70
5654,0,0,101,0,-101
5655,0,0,42,0,-42
5656,1,1,1816,1798,-18
5657,0,0,6,0,-6
5658,0,0,22,0,-22
5659,1,1,387,1261,874
5660,1,0,17,0,-17
5661,1,1,443,1213,770
5662,0,0,37,0,-37
5663,1,0,58,0,-58
5664,0,0,18,0,-18
5665,1,0,9,0,-9
5666,0,0,64,0,-64
5667,0,0,79,0,-79
5668,0,0,166,0,-166
5669,1,0,17,0,-17
5670,1,0,209,0,-209
5671,1,1,65,1707,1642
5672,0,0,21,0,-21
5673,1,1,342,2892,2550
5674,1,1,2133,1359,-774
5675,0,0,74,0,-74
5676,1,0,73,0,-73
5677,0,0,2,0,-2
5678,1,1,98,1358,1260
5679,1,0,34,0,-34
5680,0,0,29,0,-29
5681,1,1,87,1666,1579
5682,1,0,18,0,-18
5683,1,1,1199,1576,377
5684,1,0,5,0,-5
5685,1,0,55,0,-55
5686,1,0,54,0,-54
5687,0,0,6,0,-6
5688,1,1,111,2787,2676
5689,1,0,51,0,-51
5690,0,0,33,0,-33
5691,1,1,333,1232,899
5692,0,0,33,0,-33
5693,1,0,2,0,-2
5694,1,1,279,1405,1126
5695,1,1,201,2030,1829
5696,1,1,1192,2287,1095
5697,0,0,12,0,-12
5698,1,0,2,0,-2
5699,0,0,132,0,-132
5700,1,0,41,0,-41
5701,0,0,22,0,-22
5702,1,0,112,0,-112
5703,1,0,141,0,-141
5704,0,0,36,0,-36
5705,0,0,75,0,-75
5706,0,0,37,0,-37
5707,1,1,386,1518,1132
5708,1,0,145,0,-145
5709,1,0,10,0,-10
5710,0,0,17,0,-17
5711,0,0,91,0,-91
5712,1,1,90,1713,1623
5713,0,0,64,0,-64
5714,1,1,265,1437,1172
5715,0,0,60,0,-60
5716,0,0,20,0,-20
5717,1,1,434,1542,1108
5718,1,0,10,0,-10
5719,0,0,175,0,-175
5720,0,0,50,0,-50
5721,0,0,55,0,-55
5722,0,0,63,0,-63
5723,0,0,0,0,0
5724,0,0,36,0,-36
5725,1,1,54,1716,1662
5726,1,0,6,0,-6
5727,0,0,124,0,-124
5728,1,0,112,0,-112
5729,1,1,2933,1451,-1482
5730,1,0,41,0,-41
5731,1,0,97,0,-97
5732,0,0,50,0,-50
5733,0,0,13,0,-13
5734,1,0,60,0,-60
5735,1,0,44,0,-44
5736,0,0,27,0,-27
5737,1,0,34,0,-34
5738,0,0,27,0,-27
5739,1,0,49,0,-49
5740,1,1,563,1292,729
5741,0,0,83,0,-83
5742,1,0,66,0,-66
5743,1,0,14,0,-14
5744,1,1,173,1587,1414
5745,1,1,595,2188,1593
5746,0,0,57,0,-57
5747,1,1,41,1228,1187
5748,1,0,53,0,-53
5749,0,0,3,0,-3
5750,0,0,36,0,-36
5751,0,0,16,0,-16
5752,1,1,2783,1578,-1205
5753,1,1,413,1284,871
5754,1,0,19,0,-19
5755,1,1,128,1231,1103
5756,0,0,58,0,-58
5757,1,0,119,0,-119
5758,1,0,53,0,-53
5759,1,0,6,0,-6
5760,0,0,118,0,-118
5761,0,0,58,0,-58
5762,0,0,4,0,-4
5763,1,1,88,1270,1182
5764,0,0,13,0,-13
5765,1,1,298,1417,1119
5766,1,1,155,1491,1336
5767,0,0,17,0,-17
5768,0,0,65,0,-65
5769,0,0,43,0,-43
5770,0,0,51,0,-51
5771,1,1,258,1803,1545
5772,0,0,19,0,-19
5773,1,0,49,0,-49
5774,1,1,512,1228,716
5775,1,0,28,0,-28
5776,0,0,63,0,-63
5777,0,0,39,0,-39
5778,0,0,48,0,-48
5779,0,0,20,0,-20
5780,1,1,755,1314,559
5781,1,0,5,0,-5
5782,1,1,61,1915,1854
5783,1,0,221,0,-221
5784,1,0,114,0,-114
5785,0,0,31,0,-31
5786,0,0,18,0,-18
