ID,Флаг дозвона,Флаг продажи,Расходы,PV,NPV
0,0,0,0,0,0
1,1,1,709,1550,841
2,0,0,30,0,-30
3,1,1,242,3056,2814
4,1,0,57,0,-57
5,1,1,450,1247,797
6,0,0,0,0,0
7,1,1,1525,1206,-319
8,1,0,16,0,-16
9,1,1,1443,1275,-168
10,0,0,4,0,-4
11,0,0,17,0,-17
12,1,0,73,0,-73
13,0,0,20,0,-20
14,0,0,0,0,0
15,0,0,26,0,-26
16,1,1,229,1264,1035
17,1,1,819,1359,540
18,1,0,2,0,-2
19,1,0,39,0,-39
20,0,0,36,0,-36
21,1,1,107,1871,1764
22,1,1,260,1535,1275
23,0,0,16,0,-16
24,0,0,26,0,-26
25,1,0,51,0,-51
26,1,0,120,0,-120
27,0,0,2,0,-2
28,1,0,122,0,-122
29,1,1,1232,2686,1454
30,1,1,945,1246,301
31,1,0,28,0,-28
32,0,0,53,0,-53
33,1,0,32,0,-32
34,1,1,330,1236,906
35,1,0,32,0,-32
36,1,1,167,1223,1056
37,1,0,17,0,-17
38,1,1,259,1353,1094
39,1,1,868,1585,717
40,1,0,37,0,-37
41,1,0,16,0,-16
42,1,0,8,0,-8
43,0,0,19,0,-19
44,1,0,4,0,-4
45,0,0,45,0,-45
46,0,0,3,0,-3
47,0,0,11,0,-11
48,0,0,4,0,-4
49,0,0,8,0,-8
50,1,1,215,1211,996
51,1,0,48,0,-48
52,0,0,18,0,-18
53,1,1,360,1445,1085
54,0,0,157,0,-157
55,1,1,373,1304,931
56,0,0,7,0,-7
57,1,1,417,1278,861
58,1,0,39,0,-39
59,0,0,32,0,-32
60,1,0,2,0,-2
61,1,1,72,1694,1622
62,1,1,56,1527,1471
63,1,1,559,1637,1078
64,0,0,9,0,-9
65,1,1,57,1418,1361
66,1,0,17,0,-17
67,1,1,986,1239,253
68,0,0,249,0,-249
69,1,1,916,1444,528
70,0,0,22,0,-22
71,1,1,52,2064,2012
72,1,1,344,1434,1090
73,0,0,13,0,-13
74,0,0,58,0,-58
75,1,1,641,1325,684
76,1,1,1934,1856,-78
77,1,0,96,0,-96
78,0,0,9,0,-9
79,0,0,21,0,-21
80,1,0,18,0,-18
81,1,0,183,0,-183
82,1,1,59,1240,1181
83,1,1,162,2053,1891
84,0,0,14,0,-14
85,0,0,77,0,-77
86,0,0,19,0,-19
87,1,0,100,0,-100
88,1,1,1738,1992,254
89,1,1,988,1245,257
90,1,1,1106,1728,622
91,1,1,102,2021,1919
92,1,0,4,0,-4
93,1,1,159,1863,1704
94,0,0,9,0,-9
95,1,1,348,1569,1221
96,0,0,8,0,-8
97,0,0,19,0,-19
98,0,0,69,0,-69
99,0,0,69,0,-69
100,1,1,75,1239,1164
101,0,0,208,0,-208
102,1,0,67,0,-67
103,0,0,58,0,-58
104,0,0,11,0,-11
105,1,1,259,1937,1678
106,1,1,720,2014,1294
107,1,0,36,0,-36
108,1,0,6,0,-6
109,1,0,4,0,-4
110,1,0,74,0,-74
111,0,0,126,0,-126
112,1,0,68,0,-68
113,0,0,5,0,-5
114,0,0,10,0,-10
115,0,0,77,0,-77
116,0,0,6,0,-6
117,0,0,63,0,-63
118,1,0,12,0,-12
119,0,0,136,0,-136
120,1,1,1063,1269,206
121,0,0,22,0,-22
122,1,0,10,0,-10
123,1,1,408,3276,2868
124,0,0,57,0,-57
125,1,0,3,0,-3
126,1,1,317,1229,912
127,1,0,8,0,-8
128,0,0,39,0,-39
129,0,0,43,0,-43
130,1,0,22,0,-22
131,1,0,54,0,-54
132,1,0,43,0,-43
133,1,0,17,0,-17
134,0,0,59,0,-59
135,1,1,170,1547,1377
136,0,0,0,0,0
137,1,0,85,0,-85
138,0,0,32,0,-32
139,0,0,18,0,-18
140,1,1,431,1225,794
141,0,0,78,0,-78
142,1,1,1063,1203,140
143,1,0,20,0,-20
144,1,0,35,0,-35
145,1,1,882,1230,348
146,1,1,427,2389,1962
147,1,1,1126,1573,447
148,0,0,5,0,-5
149,0,0,121,0,-121
150,0,0,0,0,0
151,1,1,344,1543,1199
152,0,0,80,0,-80
153,0,0,38,0,-38
154,0,0,83,0,-83
155,1,1,62,1594,1532
156,0,0,1,0,-1
157,0,0,54,0,-54
158,0,0,6,0,-6
159,1,0,53,0,-53
160,1,0,26,0,-26
161,0,0,51,0,-51
162,1,1,361,1745,1384
163,0,0,8,0,-8
164,0,0,22,0,-22
165,1,1,548,1293,745
166,1,0,76,0,-76
167,1,1,1510,1278,-232
168,1,0,174,0,-174
169,0,0,45,0,-45
170,1,1,132,1333,1201
171,1,1,1274,1953,679
172,1,0,13,0,-13
173,0,0,77,0,-77
174,0,0,3,0,-3
175,1,1,1412,1953,541
176,1,0,39,0,-39
177,1,1,900,1212,312
178,1,1,1189,1410,221
179,1,1,541,2055,1514
180,0,0,253,0,-253
181,1,0,55,0,-55
182,0,0,61,0,-61
183,0,0,29,0,-29
184,0,0,140,0,-140
185,0,0,271,0,-271
186,0,0,13,0,-13
187,0,0,6,0,-6
188,0,0,85,0,-85
189,0,0,115,0,-115
190,0,0,13,0,-13
191,1,1,231,1682,1451
192,1,0,3,0,-3
193,1,1,426,1452,1026
194,0,0,35,0,-35
195,1,0,138,0,-138
196,1,0,9,0,-9
197,1,0,47,0,-47
198,1,1,575,1305,730
199,0,0,95,0,-95
200,0,0,3,0,-3
201,0,0,110,0,-110
202,1,1,167,1400,1233
203,1,1,873,1539,666
204,1,0,0,0,0
205,0,0,32,0,-32
206,0,0,11,0,-11
207,1,0,59,0,-59
208,0,0,71,0,-71
209,0,0,39,0,-39
210,0,0,21,0,-21
211,1,0,144,0,-144
212,0,0,4,0,-4
213,0,0,6,0,-6
214,0,0,6,0,-6
215,1,0,3,0,-3
216,1,1,951,1275,324
217,1,0,4,0,-4
218,1,0,42,0,-42
219,0,0,28,0,-28
220,0,0,210,0,-210
221,1,1,772,1588,816
222,0,0,87,0,-87
223,1,1,215,1391,1176
224,0,0,12,0,-12
225,1,1,137,1549,1412
226,1,0,8,0,-8
227,1,0,147,0,-147
228,0,0,52,0,-52
229,1,1,94,1406,1312
230,0,0,52,0,-52
231,1,0,5,0,-5
232,1,1,39,1738,1699
233,1,0,3,0,-3
234,1,0,130,0,-130
235,1,0,33,0,-33
236,1,1,233,1249,1016
237,1,1,290,1233,943
238,0,0,38,0,-38
239,1,0,165,0,-165
240,1,0,44,0,-44
241,1,1,478,1554,1076
242,0,0,63,0,-63
243,0,0,91,0,-91
244,1,1,483,1537,1054
245,1,1,702,1480,778
246,1,0,23,0,-23
247,1,1,766,1470,704
248,0,0,42,0,-42
249,1,1,80,1275,1195
250,1,1,355,1325,970
251,0,0,57,0,-57
252,1,1,80,1346,1266
253,1,1,359,1869,1510
254,0,0,37,0,-37
255,0,0,46,0,-46
256,1,1,616,1255,639
257,1,1,337,1209,872
258,1,0,30,0,-30
259,1,1,297,1740,1443
260,1,1,180,1429,1249
261,0,0,20,0,-20
262,1,0,25,0,-25
263,0,0,11,0,-11
264,0,0,28,0,-28
265,0,0,23,0,-23
266,0,0,89,0,-89
267,1,0,45,0,-45
268,1,1,848,1242,394
269,1,1,303,1420,1117
270,0,0,13,0,-13
271,1,0,0,0,0
272,1,1,696,1302,606
273,0,0,32,0,-32
274,1,0,2,0,-2
275,1,0,112,0,-112
276,0,0,45,0,-45
277,1,1,178,1457,1279
278,0,0,28,0,-28
279,1,1,745,1595,850
280,1,0,164,0,-164
281,1,0,30,0,-30
282,0,0,27,0,-27
283,1,0,78,0,-78
284,1,1,147,2423,2276
285,1,0,65,0,-65
286,1,1,979,1204,225
287,1,0,57,0,-57
288,1,0,17,0,-17
289,0,0,17,0,-17
290,1,1,382,1200,818
291,1,1,87,1343,1256
292,0,0,0,0,0
293,1,1,1171,1552,381
294,1,0,38,0,-38
295,1,1,459,1257,798
296,1,0,49,0,-49
297,0,0,1,0,-1
298,0,0,20,0,-20
299,0,0,8,0,-8
300,1,0,165,0,-165
301,1,1,327,1524,1197
302,1,1,120,1577,1457
303,0,0,58,0,-58
304,1,0,16,0,-16
305,0,0,152,0,-152
306,0,0,1,0,-1
307,0,0,73,0,-73
308,1,1,1202,1251,49
309,1,1,28,1804,1776
310,1,1,198,1351,1153
311,1,0,135,0,-135
312,1,1,563,1205,642
313,1,1,276,1209,933
314,1,0,13,0,-13
315,1,1,213,1475,1262
316,1,0,127,0,-127
317,0,0,41,0,-41
318,0,0,30,0,-30
319,0,0,4,0,-4
320,0,0,2,0,-2
321,1,1,401,1241,840
322,0,0,19,0,-19
323,1,0,27,0,-27
324,0,0,85,0,-85
325,0,0,69,0,-69
326,0,0,35,0,-35
327,1,1,978,1790,812
328,1,1,132,1234,1102
329,0,0,49,0,-49
330,1,1,88,1222,1134
331,1,0,52,0,-52
332,1,1,44,1308,1264
333,0,0,32,0,-32
334,1,0,54,0,-54
335,1,1,453,1307,854
336,1,1,565,1225,660
337,1,1,779,1433,654
338,1,1,1390,1458,68
339,1,0,106,0,-106
340,0,0,0,0,0
341,1,1,466,1491,1025
342,0,0,2,0,-2
343,1,1,416,1745,1329
344,0,0,73,0,-73
345,1,0,1,0,-1
346,1,0,8,0,-8
347,0,0,43,0,-43
348,0,0,118,0,-118
349,1,0,46,0,-46
350,1,1,124,1303,1179
351,1,1,881,1298,417
352,1,1,170,1334,1164
353,0,0,59,0,-59
354,1,0,116,0,-116
355,0,0,26,0,-26
356,1,0,7,0,-7
357,1,0,39,0,-39
358,0,0,30,0,-30
359,1,1,922,1301,379
360,0,0,8,0,-8
361,1,0,10,0,-10
362,1,1,986,1241,255
363,0,0,47,0,-47
364,1,1,447,1312,865
365,1,1,5,1815,1810
366,1,0,8,0,-8
367,0,0,105,0,-105
368,0,0,137,0,-137
369,1,1,110,1570,1460
370,0,0,41,0,-41
371,1,1,132,1214,1082
372,0,0,3,0,-3
373,1,1,959,1719,760
374,1,1,205,1262,1057
375,1,1,182,1561,1379
376,0,0,38,0,-38
377,1,1,79,2299,2220
378,1,1,869,1482,613
379,1,1,890,2921,2031
380,1,1,66,1386,1320
381,1,0,227,0,-227
382,1,0,26,0,-26
383,1,1,1270,1210,-60
384,1,1,74,2012,1938
385,1,0,17,0,-17
386,1,0,47,0,-47
387,1,0,25,0,-25
388,0,0,14,0,-14
389,0,0,24,0,-24
390,0,0,4,0,-4
391,1,0,73,0,-73
392,1,1,1931,1217,-714
393,0,0,41,0,-41
394,0,0,4,0,-4
395,0,0,49,0,-49
396,1,1,416,2153,1737
397,1,1,1715,1246,-469
398,0,0,23,0,-23
399,1,0,31,0,-31
400,1,1,587,1241,654
401,0,0,24,0,-24
402,0,0,115,0,-115
403,0,0,14,0,-14
404,1,0,12,0,-12
405,1,1,840,1236,396
406,0,0,7,0,-7
407,1,1,848,1222,374
408,0,0,5,0,-5
409,1,0,23,0,-23
410,0,0,121,0,-121
411,1,1,412,1437,1025
412,1,1,433,1397,964
413,1,1,971,1253,282
414,1,1,515,1275,760
415,1,1,354,1274,920
416,1,0,32,0,-32
417,0,0,21,0,-21
418,1,0,7,0,-7
419,1,1,853,1591,738
420,1,1,1267,1425,158
421,1,0,4,0,-4
422,1,0,11,0,-11
423,1,1,212,1412,1200
424,1,1,642,1478,836
425,1,0,2,0,-2
426,1,1,10,1327,1317
427,1,1,1110,1328,218
428,1,0,52,0,-52
429,0,0,20,0,-20
430,0,0,107,0,-107
431,0,0,77,0,-77
432,0,0,36,0,-36
433,1,0,39,0,-39
434,1,0,29,0,-29
435,0,0,208,0,-208
436,1,0,21,0,-21
437,1,1,185,1434,1249
438,1,0,30,0,-30
439,1,1,950,1363,413
440,0,0,1,0,-1
441,1,0,10,0,-10
442,1,1,1010,1434,424
443,1,1,847,1386,539
444,1,0,11,0,-11
445,0,0,9,0,-9
446,1,0,54,0,-54
447,1,1,311,1242,931
448,1,0,175,0,-175
449,0,0,75,0,-75
450,0,0,26,0,-26
451,0,0,24,0,-24
452,1,0,27,0,-27
453,0,0,137,0,-137
454,1,1,703,1631,928
455,0,0,33,0,-33
456,0,0,37,0,-37
457,1,0,7,0,-7
458,0,0,62,0,-62
459,0,0,19,0,-19
460,1,1,86,1289,1203
461,0,0,23,0,-23
462,0,0,7,0,-7
463,1,1,179,1208,1029
464,1,1,278,1238,960
465,1,1,651,1433,782
466,1,0,14,0,-14
467,0,0,12,0,-12
468,0,0,171,0,-171
469,1,1,15,1216,1201
470,1,0,37,0,-37
471,1,1,63,1327,1264
472,0,0,30,0,-30
473,0,0,4,0,-4
474,0,0,20,0,-20
475,0,0,44,0,-44
476,0,0,18,0,-18
477,1,0,7,0,-7
478,1,1,169,1658,1489
479,1,1,928,1321,393
480,1,1,327,1286,959
481,1,0,7,0,-7
482,1,0,44,0,-44
483,1,1,363,1545,1182
484,1,1,1142,1277,135
485,1,1,394,1353,959
486,0,0,48,0,-48
487,0,0,10,0,-10
488,1,0,181,0,-181
489,1,0,170,0,-170
490,1,1,139,1263,1124
491,1,1,509,1978,1469
492,1,0,13,0,-13
493,1,1,276,1246,970
494,1,1,166,1264,1098
495,1,0,11,0,-11
496,1,0,46,0,-46
497,0,0,33,0,-33
498,1,0,63,0,-63
499,1,1,1058,2889,1831
500,1,1,69,2862,2793
501,0,0,1,0,-1
502,1,0,129,0,-129
503,1,1,764,1477,713
504,1,0,61,0,-61
505,0,0,7,0,-7
506,1,1,81,1789,1708
507,0,0,50,0,-50
508,0,0,24,0,-24
509,1,1,110,2018,1908
510,0,0,87,0,-87
511,1,0,71,0,-71
512,0,0,1,0,-1
513,1,0,13,0,-13
514,1,1,616,1216,600
515,1,0,13,0,-13
516,1,1,500,1540,1040
517,1,1,253,1530,1277
518,1,1,812,1282,470
519,1,1,23,1384,1361
520,0,0,187,0,-187
521,1,1,106,1398,1292
522,1,1,1308,2143,835
523,0,0,25,0,-25
524,1,0,152,0,-152
525,1,1,1965,1286,-679
526,0,0,5,0,-5
527,0,0,60,0,-60
528,0,0,49,0,-49
529,0,0,28,0,-28
530,1,1,764,2306,1542
531,1,0,80,0,-80
532,0,0,27,0,-27
533,1,0,2,0,-2
534,0,0,4,0,-4
535,1,0,17,0,-17
536,0,0,53,0,-53
537,1,1,1197,1420,223
538,0,0,118,0,-118
539,1,0,26,0,-26
540,1,1,566,1229,663
541,0,0,284,0,-284
542,1,0,5,0,-5
543,1,0,59,0,-59
544,0,0,27,0,-27
545,0,0,179,0,-179
546,0,0,31,0,-31
547,0,0,35,0,-35
548,0,0,8,0,-8
549,1,1,59,1494,1435
550,1,0,54,0,-54
551,1,1,287,1312,1025
552,1,0,45,0,-45
553,0,0,20,0,-20
554,0,0,66,0,-66
555,1,1,154,1407,1253
556,1,1,890,1446,556
557,0,0,136,0,-136
558,1,1,264,1419,1155
559,0,0,22,0,-22
560,1,0,128,0,-128
561,0,0,33,0,-33
562,1,1,1360,1428,68
563,0,0,33,0,-33
564,1,1,353,1311,958
565,1,1,249,1302,1053
566,1,1,913,1258,345
567,0,0,37,0,-37
568,1,1,455,1272,817
569,0,0,11,0,-11
570,1,1,195,1275,1080
571,0,0,53,0,-53
572,1,1,259,1626,1367
573,0,0,178,0,-178
574,0,0,12,0,-12
575,1,0,26,0,-26
576,1,0,118,0,-118
577,1,0,78,0,-78
578,0,0,219,0,-219
579,0,0,4,0,-4
580,1,0,78,0,-78
581,0,0,228,0,-228
582,0,0,22,0,-22
583,0,0,12,0,-12
584,1,0,5,0,-5
585,1,1,265,1376,1111
586,1,1,184,1661,1477
587,0,0,22,0,-22
588,0,0,33,0,-33
589,0,0,99,0,-99
590,0,0,81,0,-81
591,1,0,31,0,-31
592,0,0,145,0,-145
593,1,1,504,1225,721
594,0,0,5,0,-5
595,1,0,33,0,-33
596,0,0,24,0,-24
597,1,0,21,0,-21
598,0,0,105,0,-105
599,1,0,33,0,-33
600,1,0,68,0,-68
601,1,1,651,1834,1183
602,0,0,28,0,-28
603,1,1,193,1430,1237
604,1,1,864,2817,1953
605,1,0,179,0,-179
606,0,0,16,0,-16
607,1,0,61,0,-61
608,0,0,11,0,-11
609,1,1,155,1382,1227
610,1,0,25,0,-25
611,1,0,105,0,-105
612,1,1,276,1695,1419
613,1,0,68,0,-68
614,1,0,20,0,-20
615,1,1,74,1235,1161
616,1,0,2,0,-2
617,0,0,5,0,-5
618,0,0,14,0,-14
619,1,1,549,1228,679
620,0,0,4,0,-4
621,1,0,5,0,-5
622,1,1,612,1263,651
623,1,0,10,0,-10
624,0,0,59,0,-59
625,0,0,38,0,-38
626,1,0,74,0,-74
627,1,0,46,0,-46
628,1,0,11,0,-11
629,0,0,33,0,-33
630,1,1,343,1279,936
631,1,1,123,1205,1082
632,1,1,736,1527,791
633,0,0,229,0,-229
634,1,0,197,0,-197
635,1,0,1,0,-1
636,0,0,17,0,-17
637,1,0,2,0,-2
638,0,0,18,0,-18
639,1,0,25,0,-25
640,0,0,12,0,-12
641,1,0,66,0,-66
642,1,1,737,1380,643
643,0,0,69,0,-69
644,1,0,10,0,-10
645,1,1,289,1546,1257
646,0,0,45,0,-45
647,1,0,108,0,-108
648,1,1,171,1476,1305
649,0,0,144,0,-144
650,0,0,210,0,-210
651,1,0,37,0,-37
652,0,0,18,0,-18
653,1,0,91,0,-91
654,0,0,128,0,-128
655,1,1,862,1590,728
656,1,1,114,1262,1148
657,1,0,53,0,-53
658,1,1,941,1255,314
659,0,0,21,0,-21
660,1,1,788,1593,805
661,0,0,99,0,-99
662,1,0,45,0,-45
663,1,1,528,1209,681
664,0,0,63,0,-63
665,0,0,66,0,-66
666,1,0,16,0,-16
667,1,0,2,0,-2
668,1,0,31,0,-31
669,1,1,378,1247,869
670,1,1,718,1459,741
671,0,0,75,0,-75
672,1,0,197,0,-197
673,0,0,102,0,-102
674,1,1,358,1240,882
675,0,0,161,0,-161
676,0,0,59,0,-59
677,1,0,3,0,-3
678,1,1,149,1627,1478
679,0,0,166,0,-166
680,1,1,3038,2371,-667
681,1,1,796,1457,661
682,1,1,1243,1944,701
683,1,1,743,2753,2010
684,1,0,103,0,-103
685,1,1,817,1533,716
686,0,0,230,0,-230
687,0,0,39,0,-39
688,0,0,205,0,-205
689,0,0,95,0,-95
690,0,0,8,0,-8
691,1,1,365,1313,948
692,1,1,177,1383,1206
693,1,1,258,1591,1333
694,0,0,57,0,-57
695,1,1,774,1352,578
696,1,1,1474,1435,-39
697,0,0,43,0,-43
698,1,1,98,2037,1939
699,1,1,161,2365,2204
700,0,0,43,0,-43
701,1,0,4,0,-4
702,1,0,31,0,-31
703,0,0,12,0,-12
704,1,1,128,1788,1660
705,0,0,28,0,-28
706,0,0,19,0,-19
707,1,0,46,0,-46
708,1,0,29,0,-29
709,1,0,60,0,-60
710,0,0,15,0,-15
711,0,0,22,0,-22
712,0,0,93,0,-93
713,1,1,129,1384,1255
714,1,1,108,1305,1197
715,1,0,1,0,-1
716,1,0,90,0,-90
717,1,0,56,0,-56
718,0,0,44,0,-44
719,0,0,0,0,0
720,1,0,26,0,-26
721,1,1,837,1260,423
722,1,1,661,1811,1150
723,1,0,25,0,-25
724,0,0,0,0,0
725,1,0,61,0,-61
726,1,1,509,1484,975
727,1,1,196,1238,1042
728,1,0,0,0,0
729,1,0,57,0,-57
730,1,1,425,1303,878
731,1,0,14,0,-14
732,1,1,325,1236,911
733,1,0,0,0,0
734,1,1,87,1419,1332
735,0,0,11,0,-11
736,1,1,1558,1287,-271
737,1,1,304,1530,1226
738,1,0,93,0,-93
739,1,0,15,0,-15
740,1,1,23,1464,1441
741,1,0,10,0,-10
742,1,1,527,1545,1018
743,0,0,2,0,-2
744,0,0,102,0,-102
745,0,0,15,0,-15
746,0,0,45,0,-45
747,1,0,84,0,-84
748,0,0,8,0,-8
749,1,0,9,0,-9
750,0,0,7,0,-7
751,1,0,22,0,-22
752,0,0,5,0,-5
753,1,1,289,1354,1065
754,0,0,127,0,-127
755,0,0,69,0,-69
756,1,1,58,1474,1416
757,1,0,8,0,-8
758,0,0,26,0,-26
759,1,0,28,0,-28
760,1,0,2,0,-2
761,1,0,22,0,-22
762,1,1,254,1995,1741
763,0,0,0,0,0
764,0,0,71,0,-71
765,1,0,34,0,-34
766,1,0,41,0,-41
767,1,0,157,0,-157
768,1,0,42,0,-42
769,1,1,355,1543,1188
770,0,0,14,0,-14
771,1,1,966,2059,1093
772,1,0,23,0,-23
773,0,0,70,0,-70
774,1,1,337,1445,1108
775,0,0,4,0,-4
776,1,0,48,0,-48
777,1,1,2175,1238,-937
778,0,0,92,0,-92
779,0,0,0,0,0
780,1,1,100,1583,1483
781,1,0,127,0,-127
782,1,1,259,2135,1876
783,1,0,101,0,-101
784,1,1,24,1292,1268
785,1,1,784,1413,629
786,0,0,53,0,-53
787,0,0,65,0,-65
788,1,1,113,2418,2305
789,1,0,76,0,-76
790,1,1,1521,1410,-111
791,0,0,81,0,-81
792,1,0,71,0,-71
793,1,1,623,1370,747
794,1,1,416,1234,818
795,1,1,1352,1407,55
796,1,0,95,0,-95
797,0,0,0,0,0
798,1,1,39,1446,1407
799,0,0,25,0,-25
800,0,0,42,0,-42
801,0,0,117,0,-117
802,0,0,39,0,-39
803,0,0,80,0,-80
804,1,0,9,0,-9
805,1,0,3,0,-3
806,1,0,50,0,-50
807,0,0,189,0,-189
808,1,0,1,0,-1
809,0,0,127,0,-127
810,0,0,96,0,-96
811,1,0,25,0,-25
812,0,0,22,0,-22
813,1,1,186,2995,2809
814,0,0,135,0,-135
815,0,0,70,0,-70
816,0,0,17,0,-17
817,1,0,1,0,-1
818,1,0,0,0,0
819,1,1,413,1451,1038
820,1,1,104,1871,1767
821,1,0,104,0,-104
822,0,0,150,0,-150
823,1,1,36,1237,1201
824,0,0,38,0,-38
825,0,0,2,0,-2
826,0,0,3,0,-3
827,1,0,71,0,-71
828,0,0,25,0,-25
829,1,1,217,1407,1190
830,0,0,44,0,-44
831,1,1,506,1273,767
832,1,1,171,1768,1597
833,0,0,33,0,-33
834,1,0,98,0,-98
835,0,0,61,0,-61
836,1,0,90,0,-90
837,1,1,702,1227,525
838,0,0,5,0,-5
839,1,0,24,0,-24
840,1,0,23,0,-23
841,1,0,46,0,-46
842,1,0,50,0,-50
843,1,0,1,0,-1
844,1,1,76,1329,1253
845,1,0,10,0,-10
846,1,1,366,2490,2124
847,1,0,21,0,-21
848,1,0,16,0,-16
849,0,0,29,0,-29
850,1,1,281,1580,1299
851,0,0,71,0,-71
852,1,1,408,1374,966
853,1,0,158,0,-158
854,0,0,165,0,-165
855,1,1,324,1278,954
856,0,0,107,0,-107
857,1,0,87,0,-87
858,1,1,256,1205,949
859,1,0,131,0,-131
860,0,0,79,0,-79
861,1,1,199,1373,1174
862,0,0,9,0,-9
863,0,0,54,0,-54
864,0,0,36,0,-36
865,1,0,12,0,-12
866,1,1,342,1208,866
867,1,1,6,1394,1388
868,0,0,98,0,-98
869,1,1,255,1315,1060
870,0,0,177,0,-177
871,0,0,29,0,-29
872,0,0,80,0,-80
873,1,0,75,0,-75
874,1,1,336,2496,2160
875,1,0,6,0,-6
876,0,0,53,0,-53
877,1,0,307,0,-307
878,0,0,68,0,-68
879,0,0,26,0,-26
880,1,1,139,1216,1077
881,1,0,50,0,-50
882,0,0,67,0,-67
883,0,0,38,0,-38
884,0,0,24,0,-24
885,0,0,3,0,-3
886,1,1,1255,1265,10
887,0,0,102,0,-102
888,1,0,59,0,-59
889,1,1,480,1293,813
890,1,1,346,1275,929
891,0,0,96,0,-96
892,1,1,158,1300,1142
893,1,0,42,0,-42
894,1,1,479,1264,785
895,1,0,34,0,-34
896,1,1,280,2421,2141
897,1,0,79,0,-79
898,0,0,145,0,-145
899,0,0,9,0,-9
900,1,0,1,0,-1
901,0,0,127,0,-127
902,1,0,109,0,-109
903,1,0,56,0,-56
904,1,0,19,0,-19
905,0,0,76,0,-76
906,0,0,0,0,0
907,1,1,1956,1977,21
908,0,0,44,0,-44
909,1,1,954,1306,352
910,1,0,0,0,0
911,1,0,42,0,-42
912,1,1,57,3407,3350
913,1,0,10,0,-10
914,0,0,46,0,-46
915,0,0,21,0,-21
916,1,0,19,0,-19
917,0,0,10,0,-10
918,1,0,37,0,-37
919,1,1,59,1260,1201
920,1,0,21,0,-21
921,1,1,526,2472,1946
922,1,1,1453,1690,237
923,0,0,3,0,-3
924,1,0,87,0,-87
925,0,0,14,0,-14
926,1,1,217,1522,1305
927,1,1,962,1375,413
928,1,1,270,1873,1603
929,0,0,5,0,-5
930,0,0,58,0,-58
931,0,0,101,0,-101
932,0,0,36,0,-36
933,1,1,1272,2005,733
934,1,1,358,1257,899
935,0,0,30,0,-30
936,1,1,268,1298,1030
937,1,0,34,0,-34
938,0,0,23,0,-23
939,1,1,801,1510,709
940,1,1,747,1314,567
941,1,0,5,0,-5
942,1,0,58,0,-58
943,1,1,947,1263,316
944,1,0,122,0,-122
945,0,0,7,0,-7
946,0,0,11,0,-11
947,1,0,85,0,-85
948,1,0,2,0,-2
949,1,0,67,0,-67
950,1,1,347,1464,1117
951,0,0,103,0,-103
952,1,1,1244,1310,66
953,0,0,89,0,-89
954,0,0,21,0,-21
955,0,0,32,0,-32
956,0,0,92,0,-92
957,1,0,23,0,-23
958,1,1,292,1517,1225
959,1,1,706,1659,953
960,1,0,111,0,-111
961,0,0,32,0,-32
962,0,0,5,0,-5
963,0,0,278,0,-278
964,1,0,13,0,-13
965,1,0,43,0,-43
966,0,0,63,0,-63
967,0,0,37,0,-37
968,1,0,26,0,-26
969,0,0,78,0,-78
970,1,1,1213,1342,129
971,1,0,181,0,-181
972,1,1,299,1467,1168
973,1,1,137,1320,1183
974,0,0,77,0,-77
975,1,0,11,0,-11
976,0,0,130,0,-130
977,0,0,10,0,-10
978,0,0,6,0,-6
979,1,0,48,0,-48
980,1,0,40,0,-40
981,0,0,119,0,-119
982,0,0,44,0,-44
983,0,0,25,0,-25
984,0,0,114,0,-114
985,0,0,63,0,-63
986,0,0,21,0,-21
987,1,1,454,1414,960
988,0,0,25,0,-25
989,1,0,91,0,-91
990,0,0,25,0,-25
991,0,0,96,0,-96
992,1,0,12,0,-12
993,1,0,0,0,0
994,1,1,291,1437,1146
995,1,1,481,2080,1599
996,1,1,504,1728,1224
997,1,1,75,1814,1739
998,1,1,2893,1381,-1512
999,1,1,867,1212,345
1000,1,0,27,0,-27
1001,1,1,52,1994,1942
1002,1,0,51,0,-51
1003,1,1,1775,3354,1579
1004,1,0,13,0,-13
1005,1,1,1944,1611,-333
1006,0,0,8,0,-8
1007,1,0,42,0,-42
1008,1,1,806,1465,659
1009,1,1,1103,1797,694
1010,0,0,126,0,-126
1011,0,0,42,0,-42
1012,0,0,64,0,-64
1013,0,0,31,0,-31
1014,1,1,917,1215,298
1015,1,1,342,1262,920
1016,1,1,1063,1226,163
1017,1,0,26,0,-26
1018,1,0,36,0,-36
1019,0,0,2,0,-2
1020,0,0,10,0,-10
1021,1,0,44,0,-44
1022,0,0,1,0,-1
1023,0,0,4,0,-4
1024,0,0,7,0,-7
1025,1,0,29,0,-29
1026,1,1,287,1247,960
1027,0,0,57,0,-57
1028,1,1,515,1433,918
1029,1,1,134,3285,3151
1030,0,0,16,0,-16
1031,1,1,226,1713,1487
1032,0,0,4,0,-4
1033,1,1,570,1478,908
1034,1,0,56,0,-56
1035,0,0,29,0,-29
1036,1,1,252,1602,1350
1037,1,1,66,2204,2138
1038,1,0,65,0,-65
1039,1,1,493,2237,1744
1040,0,0,2,0,-2
1041,1,1,200,1317,1117
1042,1,0,67,0,-67
1043,0,0,101,0,-101
1044,1,1,1585,1350,-235
1045,1,0,62,0,-62
1046,1,1,358,1315,957
1047,1,1,295,1353,1058
1048,1,0,71,0,-71
1049,0,0,23,0,-23
1050,1,1,438,1388,950
1051,1,0,35,0,-35
1052,1,0,144,0,-144
1053,1,1,576,1304,728
1054,1,0,40,0,-40
1055,0,0,40,0,-40
1056,1,0,41,0,-41
1057,1,1,960,1326,366
1058,1,0,16,0,-16
1059,0,0,135,0,-135
1060,0,0,48,0,-48
1061,1,1,104,1233,1129
1062,1,1,1984,1203,-781
1063,1,0,73,0,-73
1064,0,0,43,0,-43
1065,1,0,103,0,-103
1066,1,1,368,1265,897
1067,1,1,1219,1357,138
1068,0,0,17,0,-17
1069,1,1,356,1343,987
1070,0,0,5,0,-5
1071,0,0,76,0,-76
1072,1,1,1268,1394,126
1073,1,0,13,0,-13
1074,1,1,1174,1345,171
1075,1,1,272,1641,1369
1076,1,1,106,1548,1442
1077,0,0,98,0,-98
1078,1,1,552,1425,873
1079,1,0,26,0,-26
1080,0,0,43,0,-43
1081,1,1,244,1597,1353
1082,1,1,240,1696,1456
1083,0,0,33,0,-33
1084,1,1,284,1462,1178
1085,1,1,175,1372,1197
1086,1,0,21,0,-21
1087,0,0,15,0,-15
1088,1,0,105,0,-105
1089,0,0,72,0,-72
1090,1,0,4,0,-4
1091,1,0,57,0,-57
1092,1,1,98,1264,1166
1093,1,1,756,1535,779
1094,0,0,80,0,-80
1095,1,0,29,0,-29
1096,0,0,29,0,-29
1097,0,0,90,0,-90
1098,1,1,466,1265,799
1099,1,0,63,0,-63
1100,1,0,1,0,-1
1101,0,0,1,0,-1
1102,0,0,15,0,-15
1103,1,0,48,0,-48
1104,0,0,16,0,-16
1105,1,0,44,0,-44
1106,0,0,67,0,-67
1107,1,1,362,2097,1735
1108,1,1,535,1244,709
1109,1,1,663,1342,679
1110,1,0,31,0,-31
1111,0,0,28,0,-28
1112,0,0,68,0,-68
1113,0,0,94,0,-94
1114,1,1,92,2098,2006
1115,0,0,6,0,-6
1116,1,1,142,1414,1272
1117,1,1,112,1561,1449
1118,1,0,7,0,-7
1119,0,0,113,0,-113
1120,0,0,11,0,-11
1121,1,1,1509,1284,-225
1122,1,1,962,1942,980
1123,1,1,187,1410,1223
1124,0,0,168,0,-168
1125,1,1,346,2647,2301
1126,0,0,77,0,-77
1127,0,0,168,0,-168
1128,1,0,124,0,-124
1129,0,0,33,0,-33
1130,0,0,60,0,-60
1131,0,0,11,0,-11
1132,0,0,18,0,-18
1133,0,0,92,0,-92
1134,1,0,29,0,-29
1135,0,0,119,0,-119
1136,0,0,10,0,-10
1137,0,0,203,0,-203
1138,0,0,133,0,-133
1139,0,0,17,0,-17
1140,1,0,11,0,-11
1141,0,0,35,0,-35
1142,1,1,35,1366,1331
1143,0,0,47,0,-47
1144,1,0,76,0,-76
1145,1,1,415,1219,804
1146,1,1,600,1223,623
1147,0,0,48,0,-48
1148,1,0,88,0,-88
1149,0,0,21,0,-21
1150,1,0,6,0,-6
1151,0,0,91,0,-91
1152,0,0,70,0,-70
1153,0,0,3,0,-3
1154,0,0,8,0,-8
1155,1,0,14,0,-14
1156,1,1,133,1660,1527
1157,0,0,158,0,-158
1158,1,1,489,1476,987
1159,1,1,49,1251,1202
1160,1,1,732,1302,570
1161,0,0,2,0,-2
1162,1,1,392,1433,1041
1163,0,0,57,0,-57
1164,1,1,158,2509,2351
1165,1,1,198,1694,1496
1166,1,0,27,0,-27
1167,1,1,145,1582,1437
1168,1,0,42,0,-42
1169,1,0,27,0,-27
1170,0,0,22,0,-22
1171,1,0,14,0,-14
1172,1,0,3,0,-3
1173,1,1,493,1534,1041
1174,1,1,187,2900,2713
1175,1,1,49,1463,1414
1176,1,0,35,0,-35
1177,1,0,18,0,-18
1178,1,0,29,0,-29
1179,1,0,6,0,-6
1180,0,0,10,0,-10
1181,0,0,11,0,-11
1182,1,1,435,1349,914
1183,0,0,28,0,-28
1184,0,0,2,0,-2
1185,0,0,148,0,-148
1186,0,0,11,0,-11
1187,0,0,75,0,-75
1188,1,1,774,1682,908
1189,0,0,21,0,-21
1190,0,0,96,0,-96
1191,1,0,38,0,-38
1192,0,0,24,0,-24
1193,0,0,135,0,-135
1194,0,0,125,0,-125
1195,0,0,56,0,-56
1196,1,1,662,1263,601
1197,1,0,9,0,-9
1198,1,0,21,0,-21
1199,1,0,162,0,-162
1200,1,0,139,0,-139
1201,0,0,10,0,-10
1202,1,0,2,0,-2
1203,0,0,17,0,-17
1204,1,1,44,1378,1334
1205,0,0,1,0,-1
1206,1,0,4,0,-4
1207,1,1,61,1398,1337
1208,1,0,85,0,-85
1209,0,0,132,0,-132
1210,1,0,64,0,-64
1211,1,1,673,1450,777
1212,1,0,11,0,-11
1213,0,0,50,0,-50
1214,0,0,24,0,-24
1215,1,0,99,0,-99
1216,0,0,129,0,-129
1217,1,0,77,0,-77
1218,1,1,249,3163,2914
1219,1,0,40,0,-40
1220,0,0,6,0,-6
1221,1,1,262,1467,1205
1222,0,0,34,0,-34
1223,1,0,3,0,-3
1224,0,0,52,0,-52
1225,1,1,37,4003,3966
1226,1,0,105,0,-105
1227,1,1,535,1351,816
1228,0,0,150,0,-150
1229,0,0,120,0,-120
1230,0,0,36,0,-36
1231,1,0,2,0,-2
1232,0,0,1,0,-1
1233,0,0,31,0,-31
1234,1,0,48,0,-48
1235,0,0,23,0,-23
1236,1,0,211,0,-211
1237,1,0,21,0,-21
1238,0,0,18,0,-18
1239,0,0,60,0,-60
1240,0,0,51,0,-51
1241,1,0,16,0,-16
1242,1,1,1060,1833,773
1243,1,1,247,1479,1232
1244,1,1,1594,1630,36
1245,1,0,7,0,-7
1246,0,0,29,0,-29
1247,0,0,222,0,-222
1248,0,0,13,0,-13
1249,1,1,1000,1264,264
1250,0,0,15,0,-15
1251,0,0,12,0,-12
1252,0,0,4,0,-4
1253,0,0,163,0,-163
1254,1,0,8,0,-8
1255,0,0,41,0,-41
1256,0,0,50,0,-50
1257,0,0,35,0,-35
1258,1,0,3,0,-3
1259,1,1,893,1455,562
1260,1,0,133,0,-133
1261,1,0,43,0,-43
1262,1,0,67,0,-67
1263,1,0,77,0,-77
1264,1,0,35,0,-35
1265,1,0,45,0,-45
1266,0,0,12,0,-12
1267,0,0,73,0,-73
1268,1,0,51,0,-51
1269,1,0,2,0,-2
1270,1,0,56,0,-56
1271,1,1,906,1276,370
1272,0,0,37,0,-37
1273,0,0,18,0,-18
1274,0,0,166,0,-166
1275,1,0,11,0,-11
1276,1,0,38,0,-38
1277,1,0,69,0,-69
1278,0,0,117,0,-117
1279,0,0,83,0,-83
1280,1,0,38,0,-38
1281,1,0,70,0,-70
1282,1,1,226,1327,1101
1283,1,0,16,0,-16
1284,1,0,7,0,-7
1285,0,0,83,0,-83
1286,1,0,69,0,-69
1287,0,0,29,0,-29
1288,1,0,48,0,-48
1289,1,1,82,1694,1612
1290,1,1,56,1210,1154
1291,1,0,54,0,-54
1292,1,1,722,1364,642
1293,1,1,484,1292,808
1294,0,0,5,0,-5
1295,1,1,44,1661,1617
1296,0,0,10,0,-10
1297,0,0,61,0,-61
1298,1,0,20,0,-20
1299,0,0,5,0,-5
1300,1,1,421,1476,1055
1301,1,1,249,1443,1194
1302,1,1,475,1513,1038
1303,1,1,617,1297,680
1304,1,0,13,0,-13
1305,1,0,53,0,-53
1306,1,1,233,1431,1198
1307,1,1,1634,1490,-144
1308,1,1,608,1479,871
1309,0,0,89,0,-89
1310,1,0,95,0,-95
1311,0,0,108,0,-108
1312,1,1,117,1508,1391
1313,0,0,4,0,-4
1314,0,0,22,0,-22
1315,0,0,12,0,-12
1316,0,0,106,0,-106
1317,1,0,34,0,-34
1318,0,0,40,0,-40
1319,1,1,873,1707,834
1320,1,0,62,0,-62
1321,0,0,36,0,-36
1322,0,0,85,0,-85
1323,0,0,59,0,-59
1324,0,0,23,0,-23
1325,1,1,774,1801,1027
1326,1,1,160,1225,1065
1327,1,0,39,0,-39
1328,0,0,0,0,0
1329,1,1,618,1221,603
1330,1,0,47,0,-47
1331,1,0,13,0,-13
1332,0,0,18,0,-18
1333,0,0,53,0,-53
1334,0,0,65,0,-65
1335,0,0,98,0,-98
1336,0,0,33,0,-33
1337,1,1,473,1775,1302
1338,0,0,63,0,-63
1339,1,0,57,0,-57
1340,1,0,53,0,-53
1341,1,0,38,0,-38
1342,0,0,0,0,0
1343,1,0,82,0,-82
1344,0,0,126,0,-126
1345,0,0,47,0,-47
1346,0,0,25,0,-25
1347,1,0,64,0,-64
1348,1,1,203,1630,1427
1349,1,1,90,1496,1406
1350,0,0,37,0,-37
1351,0,0,100,0,-100
1352,1,1,1089,1811,722
1353,1,0,56,0,-56
1354,1,1,99,1539,1440
1355,1,1,1104,2004,900
1356,1,0,8,0,-8
1357,0,0,25,0,-25
1358,1,0,8,0,-8
1359,0,0,13,0,-13
1360,0,0,88,0,-88
1361,0,0,59,0,-59
1362,1,0,55,0,-55
1363,1,0,17,0,-17
1364,1,1,714,1675,961
1365,1,0,18,0,-18
1366,1,0,0,0,0
1367,1,0,59,0,-59
1368,1,0,17,0,-17
1369,1,0,61,0,-61
1370,1,0,0,0,0
1371,1,1,814,1337,523
1372,1,0,44,0,-44
1373,0,0,35,0,-35
1374,1,1,287,1277,990
1375,1,0,14,0,-14
1376,1,1,100,1286,1186
1377,0,0,169,0,-169
1378,0,0,11,0,-11
1379,0,0,22,0,-22
1380,1,1,1345,2056,711
1381,1,1,543,1783,1240
1382,0,0,32,0,-32
1383,1,0,8,0,-8
1384,0,0,105,0,-105
1385,1,0,129,0,-129
1386,0,0,70,0,-70
1387,0,0,36,0,-36
1388,1,1,958,1651,693
1389,1,0,16,0,-16
1390,1,0,0,0,0
1391,1,0,179,0,-179
1392,0,0,24,0,-24
1393,0,0,90,0,-90
1394,1,1,1182,1472,290
1395,1,0,90,0,-90
1396,0,0,2,0,-2
1397,1,1,204,1443,1239
1398,1,0,22,0,-22
1399,1,1,115,1287,1172
1400,0,0,35,0,-35
1401,1,1,2073,1242,-831
1402,1,0,12,0,-12
1403,1,1,1057,1546,489
1404,0,0,11,0,-11
1405,0,0,42,0,-42
1406,1,1,319,1221,902
1407,1,1,257,1677,1420
1408,0,0,261,0,-261
1409,0,0,13,0,-13
1410,0,0,5,0,-5
1411,1,1,290,1312,1022
1412,1,1,524,1203,679
1413,0,0,3,0,-3
1414,0,0,15,0,-15
1415,0,0,25,0,-25
1416,0,0,129,0,-129
1417,1,1,315,2463,2148
1418,1,0,8,0,-8
1419,1,1,325,1429,1104
1420,1,0,52,0,-52
1421,1,1,1598,1229,-369
1422,1,0,83,0,-83
1423,1,1,603,1214,611
1424,0,0,21,0,-21
1425,1,1,309,1394,1085
1426,1,1,1067,1763,696
1427,0,0,12,0,-12
1428,0,0,33,0,-33
1429,0,0,11,0,-11
1430,1,0,44,0,-44
1431,1,0,40,0,-40
1432,0,0,7,0,-7
1433,0,0,1,0,-1
1434,0,0,75,0,-75
1435,0,0,50,0,-50
1436,1,1,83,1358,1275
1437,0,0,16,0,-16
1438,0,0,10,0,-10
1439,0,0,49,0,-49
1440,0,0,23,0,-23
1441,0,0,26,0,-26
1442,0,0,52,0,-52
1443,1,0,8,0,-8
1444,1,1,1452,1650,198
1445,0,0,135,0,-135
1446,1,0,39,0,-39
1447,0,0,1,0,-1
1448,0,0,3,0,-3
1449,0,0,51,0,-51
1450,0,0,14,0,-14
1451,1,0,43,0,-43
1452,0,0,4,0,-4
1453,1,0,18,0,-18
1454,1,1,1698,2180,482
1455,1,1,351,1517,1166
1456,1,1,269,1432,1163
1457,1,0,9,0,-9
1458,0,0,9,0,-9
1459,1,0,55,0,-55
1460,1,1,930,1373,443
1461,0,0,10,0,-10
1462,0,0,85,0,-85
1463,1,1,570,1409,839
1464,0,0,122,0,-122
1465,1,0,6,0,-6
1466,1,1,440,1514,1074
1467,1,1,434,1267,833
1468,0,0,28,0,-28
1469,0,0,26,0,-26
1470,0,0,10,0,-10
1471,1,1,190,1224,1034
1472,1,0,5,0,-5
1473,1,1,134,1337,1203
1474,0,0,27,0,-27
1475,0,0,157,0,-157
1476,1,0,0,0,0
1477,1,1,766,1425,659
1478,1,1,115,1228,1113
1479,1,1,389,1305,916
1480,1,1,841,1244,403
1481,1,0,117,0,-117
1482,0,0,158,0,-158
1483,0,0,28,0,-28
1484,1,1,1593,1234,-359
1485,1,1,864,1426,562
1486,0,0,5,0,-5
1487,0,0,26,0,-26
1488,0,0,20,0,-20
1489,1,1,736,1622,886
1490,1,1,138,1899,1761
1491,0,0,35,0,-35
1492,0,0,77,0,-77
1493,0,0,43,0,-43
1494,0,0,56,0,-56
1495,1,1,206,1221,1015
1496,1,0,48,0,-48
1497,0,0,15,0,-15
1498,0,0,108,0,-108
1499,1,1,436,1276,840
1500,1,1,46,2936,2890
1501,1,0,4,0,-4
1502,0,0,38,0,-38
1503,1,1,997,1238,241
1504,0,0,14,0,-14
1505,1,1,429,1440,1011
1506,1,0,121,0,-121
1507,1,0,49,0,-49
1508,0,0,14,0,-14
1509,1,0,42,0,-42
1510,0,0,16,0,-16
1511,1,1,132,1204,1072
1512,0,0,113,0,-113
1513,1,1,514,1201,687
1514,1,0,60,0,-60
1515,1,1,956,1385,429
1516,1,0,9,0,-9
1517,0,0,23,0,-23
1518,0,0,53,0,-53
1519,1,1,239,1447,1208
1520,1,1,369,2821,2452
1521,1,1,407,1213,806
1522,1,1,437,1712,1275
1523,1,1,991,1211,220
1524,0,0,5,0,-5
1525,1,1,34,1371,1337
1526,1,0,65,0,-65
1527,1,0,8,0,-8
1528,0,0,43,0,-43
1529,0,0,6,0,-6
1530,0,0,40,0,-40
1531,1,0,52,0,-52
1532,0,0,8,0,-8
1533,0,0,11,0,-11
1534,0,0,40,0,-40
1535,0,0,52,0,-52
1536,0,0,22,0,-22
1537,1,1,699,1586,887
1538,1,1,974,1374,400
1539,1,1,254,1645,1391
1540,1,0,6,0,-6
1541,1,1,827,1202,375
1542,0,0,29,0,-29
1543,1,1,33,1672,1639
1544,0,0,57,0,-57
1545,0,0,166,0,-166
1546,0,0,70,0,-70
1547,1,0,2,0,-2
1548,0,0,45,0,-45
1549,0,0,38,0,-38
1550,1,0,38,0,-38
1551,0,0,19,0,-19
1552,1,1,4083,1425,-2658
1553,0,0,46,0,-46
1554,1,1,578,1356,778
1555,0,0,56,0,-56
1556,1,0,149,0,-149
1557,0,0,25,0,-25
1558,1,0,1,0,-1
1559,1,1,572,2034,1462
1560,1,1,748,1296,548
1561,1,1,116,1314,1198
1562,1,0,1,0,-1
1563,1,0,34,0,-34
1564,0,0,46,0,-46
1565,1,0,19,0,-19
1566,1,1,1208,1432,224
1567,1,1,76,1232,1156
1568,0,0,2,0,-2
1569,0,0,29,0,-29
1570,0,0,8,0,-8
1571,1,0,66,0,-66
1572,0,0,5,0,-5
1573,1,0,22,0,-22
1574,1,1,233,1572,1339
1575,0,0,36,0,-36
1576,1,1,406,1348,942
1577,0,0,13,0,-13
1578,0,0,79,0,-79
1579,1,0,9,0,-9
1580,0,0,13,0,-13
1581,1,0,79,0,-79
1582,1,1,532,1510,978
1583,1,1,133,1439,1306
1584,0,0,17,0,-17
1585,0,0,1,0,-1
1586,0,0,44,0,-44
1587,0,0,14,0,-14
1588,1,1,565,1444,879
1589,0,0,23,0,-23
1590,0,0,66,0,-66
1591,0,0,82,0,-82
1592,0,0,21,0,-21
1593,0,0,42,0,-42
1594,1,1,139,1733,1594
1595,0,0,2,0,-2
1596,1,1,336,1210,874
1597,0,0,368,0,-368
1598,1,0,81,0,-81
1599,1,1,257,1324,1067
1600,1,1,632,1231,599
1601,0,0,61,0,-61
1602,1,0,45,0,-45
1603,0,0,24,0,-24
1604,1,0,14,0,-14
1605,0,0,8,0,-8
1606,1,1,173,1257,1084
1607,1,1,83,1281,1198
1608,1,0,117,0,-117
1609,0,0,26,0,-26
1610,0,0,54,0,-54
1611,1,0,105,0,-105
1612,0,0,31,0,-31
1613,0,0,16,0,-16
1614,1,0,46,0,-46
1615,1,1,697,1324,627
1616,0,0,44,0,-44
1617,0,0,2,0,-2
1618,0,0,11,0,-11
1619,0,0,4,0,-4
1620,0,0,47,0,-47
1621,1,1,2035,1322,-713
1622,1,1,650,1832,1182
1623,1,0,6,0,-6
1624,0,0,150,0,-150
1625,0,0,117,0,-117
1626,1,0,33,0,-33
1627,1,0,3,0,-3
1628,1,1,531,1421,890
1629,0,0,5,0,-5
1630,1,1,131,1518,1387
1631,1,0,11,0,-11
1632,0,0,23,0,-23
1633,0,0,57,0,-57
1634,1,1,413,1688,1275
1635,1,0,2,0,-2
1636,0,0,6,0,-6
1637,1,0,61,0,-61
1638,1,0,38,0,-38
1639,1,0,66,0,-66
1640,1,0,50,0,-50
1641,0,0,139,0,-139
1642,1,1,469,1211,742
1643,1,1,1035,1233,198
1644,1,0,39,0,-39
1645,0,0,29,0,-29
1646,0,0,67,0,-67
1647,0,0,84,0,-84
1648,0,0,5,0,-5
1649,0,0,6,0,-6
1650,0,0,21,0,-21
1651,0,0,20,0,-20
1652,0,0,48,0,-48
1653,0,0,51,0,-51
1654,0,0,51,0,-51
1655,1,1,1381,1601,220
1656,1,0,240,0,-240
1657,0,0,0,0,0
1658,1,0,182,0,-182
1659,1,1,218,1302,1084
1660,1,1,50,1357,1307
1661,1,0,15,0,-15
1662,1,1,43,1545,1502
1663,1,0,102,0,-102
1664,0,0,23,0,-23
1665,0,0,47,0,-47
1666,0,0,15,0,-15
1667,1,0,22,0,-22
1668,1,0,75,0,-75
1669,0,0,188,0,-188
1670,1,1,848,1914,1066
1671,0,0,47,0,-47
1672,0,0,0,0,0
1673,0,0,51,0,-51
1674,1,1,107,1425,1318
1675,1,0,92,0,-92
1676,0,0,32,0,-32
1677,1,0,2,0,-2
1678,1,1,362,1494,1132
1679,0,0,31,0,-31
1680,1,0,199,0,-199
1681,0,0,2,0,-2
1682,0,0,58,0,-58
1683,1,0,1,0,-1
1684,1,0,73,0,-73
1685,1,1,768,1387,619
1686,1,1,46,1326,1280
1687,1,0,104,0,-104
1688,1,1,103,1782,1679
1689,0,0,54,0,-54
1690,1,0,11,0,-11
1691,0,0,22,0,-22
1692,1,1,279,1487,1208
1693,1,1,759,1559,800
1694,0,0,38,0,-38
1695,1,1,274,2382,2108
1696,1,0,2,0,-2
1697,1,1,588,1411,823
1698,0,0,9,0,-9
1699,0,0,7,0,-7
1700,0,0,26,0,-26
1701,1,1,151,1425,1274
1702,0,0,259,0,-259
1703,1,1,284,1278,994
1704,1,1,435,1784,1349
1705,0,0,77,0,-77
1706,1,1,325,1420,1095
1707,1,0,7,0,-7
1708,1,1,545,1454,909
1709,1,1,402,1298,896
1710,1,1,76,1424,1348
1711,1,0,104,0,-104
1712,0,0,189,0,-189
1713,1,0,49,0,-49
1714,0,0,6,0,-6
1715,1,0,17,0,-17
1716,0,0,94,0,-94
1717,0,0,95,0,-95
1718,1,0,49,0,-49
1719,0,0,2,0,-2
1720,0,0,6,0,-6
1721,1,0,60,0,-60
1722,0,0,11,0,-11
1723,0,0,27,0,-27
1724,1,0,3,0,-3
1725,1,1,623,1297,674
1726,1,1,1093,1287,194
1727,1,0,7,0,-7
1728,0,0,63,0,-63
1729,1,0,1,0,-1
1730,0,0,9,0,-9
1731,1,1,349,1611,1262
1732,0,0,2,0,-2
1733,1,0,91,0,-91
1734,1,0,62,0,-62
1735,1,0,41,0,-41
1736,1,1,1100,2310,1210
1737,1,1,399,1207,808
1738,1,0,28,0,-28
1739,1,0,51,0,-51
1740,1,1,607,1530,923
1741,1,0,45,0,-45
1742,1,1,191,1249,1058
1743,1,1,284,1335,1051
1744,0,0,67,0,-67
1745,1,1,1510,1327,-183
1746,0,0,36,0,-36
1747,1,0,31,0,-31
1748,1,1,1934,1336,-598
1749,0,0,23,0,-23
1750,0,0,8,0,-8
1751,0,0,26,0,-26
1752,0,0,8,0,-8
1753,1,1,153,2522,2369
1754,1,1,638,1212,574
1755,1,1,930,1581,651
1756,1,1,488,1301,813
1757,1,1,358,1609,1251
1758,1,1,177,3777,3600
1759,0,0,24,0,-24
1760,1,1,123,1996,1873
1761,1,1,18,1987,1969
1762,0,0,24,0,-24
1763,1,0,65,0,-65
1764,1,1,2067,1520,-547
1765,1,0,53,0,-53
1766,0,0,29,0,-29
1767,0,0,0,0,0
1768,0,0,66,0,-66
1769,0,0,7,0,-7
1770,0,0,20,0,-20
1771,0,0,73,0,-73
1772,1,1,68,2013,1945
1773,1,0,105,0,-105
1774,1,0,2,0,-2
1775,0,0,18,0,-18
1776,0,0,63,0,-63
1777,1,1,64,1577,1513
1778,0,0,60,0,-60
1779,1,0,11,0,-11
1780,1,1,92,1453,1361
1781,0,0,57,0,-57
1782,1,1,602,1668,1066
1783,1,0,28,0,-28
1784,0,0,33,0,-33
1785,0,0,4,0,-4
1786,1,1,176,1221,1045
1787,0,0,3,0,-3
1788,1,1,427,1504,1077
1789,1,1,148,1220,1072
1790,0,0,27,0,-27
1791,1,1,626,1392,766
1792,1,1,2725,1304,-1421
1793,1,1,14,1214,1200
1794,1,1,503,1601,1098
1795,1,0,62,0,-62
1796,0,0,64,0,-64
1797,1,1,156,1407,1251
1798,1,1,466,1899,1433
1799,0,0,5,0,-5
1800,1,1,123,1239,1116
1801,1,0,30,0,-30
1802,1,0,59,0,-59
1803,1,0,1,0,-1
1804,1,0,107,0,-107
1805,1,0,7,0,-7
1806,1,1,207,1270,1063
1807,1,1,109,1539,1430
1808,0,0,38,0,-38
1809,0,0,18,0,-18
1810,0,0,29,0,-29
1811,0,0,33,0,-33
1812,1,0,84,0,-84
1813,0,0,14,0,-14
1814,1,0,53,0,-53
1815,1,1,1370,1268,-102
1816,1,0,158,0,-158
1817,1,0,16,0,-16
1818,0,0,5,0,-5
1819,1,1,1077,1236,159
1820,0,0,33,0,-33
1821,0,0,46,0,-46
1822,0,0,82,0,-82
1823,1,0,4,0,-4
1824,0,0,29,0,-29
1825,1,0,6,0,-6
1826,1,1,736,1287,551
1827,0,0,88,0,-88
1828,0,0,12,0,-12
1829,1,0,65,0,-65
1830,0,0,100,0,-100
1831,0,0,58,0,-58
1832,0,0,16,0,-16
1833,1,0,82,0,-82
1834,1,1,616,1226,610
1835,0,0,0,0,0
1836,0,0,245,0,-245
1837,1,0,34,0,-34
1838,1,1,103,1320,1217
1839,1,1,564,1897,1333
1840,0,0,153,0,-153
1841,1,0,229,0,-229
1842,0,0,32,0,-32
1843,0,0,60,0,-60
1844,0,0,5,0,-5
1845,0,0,3,0,-3
1846,0,0,103,0,-103
1847,1,0,70,0,-70
1848,1,1,98,1925,1827
1849,0,0,3,0,-3
1850,1,0,29,0,-29
1851,0,0,24,0,-24
1852,0,0,72,0,-72
1853,0,0,140,0,-140
1854,1,0,36,0,-36
1855,1,1,194,2576,2382
1856,1,0,89,0,-89
1857,0,0,24,0,-24
1858,1,0,58,0,-58
1859,1,1,58,1412,1354
1860,1,1,272,1203,931
1861,1,1,279,1383,1104
1862,0,0,41,0,-41
1863,1,1,230,1272,1042
1864,1,1,81,1673,1592
1865,1,0,78,0,-78
1866,1,1,205,1543,1338
1867,0,0,28,0,-28
1868,0,0,24,0,-24
1869,0,0,79,0,-79
1870,1,1,1341,1303,-38
1871,1,1,454,1311,857
1872,0,0,17,0,-17
1873,0,0,28,0,-28
1874,1,1,19,1550,1531
1875,1,1,152,1355,1203
1876,1,1,1028,1437,409
1877,1,0,29,0,-29
1878,0,0,34,0,-34
1879,0,0,32,0,-32
1880,1,0,28,0,-28
1881,0,0,7,0,-7
1882,1,1,181,2034,1853
1883,0,0,90,0,-90
1884,1,0,69,0,-69
1885,0,0,6,0,-6
1886,0,0,76,0,-76
1887,1,0,23,0,-23
1888,1,1,335,1359,1024
1889,0,0,16,0,-16
1890,1,1,115,2385,2270
1891,1,1,394,1300,906
1892,0,0,80,0,-80
1893,1,0,61,0,-61
1894,1,0,53,0,-53
1895,1,1,67,2015,1948
1896,1,1,182,1206,1024
1897,1,0,0,0,0
1898,0,0,38,0,-38
1899,1,1,218,1281,1063
1900,1,0,57,0,-57
1901,1,1,351,1773,1422
1902,1,1,38,3741,3703
1903,1,1,136,1389,1253
1904,0,0,0,0,0
1905,1,0,109,0,-109
1906,1,0,14,0,-14
1907,1,0,46,0,-46
1908,1,1,62,1385,1323
1909,0,0,26,0,-26
1910,1,0,66,0,-66
1911,0,0,34,0,-34
1912,1,0,61,0,-61
1913,1,0,18,0,-18
1914,1,1,311,1424,1113
1915,1,1,551,1336,785
1916,1,1,25,3190,3165
1917,1,0,16,0,-16
1918,0,0,36,0,-36
1919,0,0,42,0,-42
1920,1,1,59,1733,1674
1921,1,1,693,1306,613
1922,1,1,579,1264,685
1923,0,0,14,0,-14
1924,1,1,320,1446,1126
1925,0,0,58,0,-58
1926,0,0,75,0,-75
1927,1,1,479,2244,1765
1928,0,0,1,0,-1
1929,0,0,23,0,-23
1930,0,0,35,0,-35
1931,1,0,16,0,-16
1932,0,0,65,0,-65
1933,1,1,906,1503,597
1934,1,0,22,0,-22
1935,1,0,27,0,-27
1936,1,1,169,1920,1751
1937,1,1,75,1408,1333
1938,0,0,145,0,-145
1939,0,0,80,0,-80
1940,0,0,5,0,-5
1941,1,1,526,1765,1239
1942,0,0,11,0,-11
1943,1,0,29,0,-29
1944,1,1,226,1262,1036
1945,1,1,102,1338,1236
1946,1,1,310,2046,1736
1947,1,1,781,1209,428
1948,1,1,635,1410,775
1949,0,0,71,0,-71
1950,0,0,52,0,-52
1951,1,0,20,0,-20
1952,1,1,393,1842,1449
1953,1,1,61,1425,1364
1954,1,1,1171,1356,185
1955,1,0,18,0,-18
1956,1,1,363,2231,1868
1957,1,1,218,1420,1202
1958,1,1,1003,1268,265
1959,1,1,434,1627,1193
1960,1,0,89,0,-89
1961,0,0,51,0,-51
1962,0,0,144,0,-144
1963,0,0,31,0,-31
1964,0,0,119,0,-119
1965,1,0,28,0,-28
1966,1,0,91,0,-91
1967,1,0,45,0,-45
1968,1,0,86,0,-86
1969,1,0,32,0,-32
1970,1,1,146,1562,1416
1971,0,0,3,0,-3
1972,0,0,61,0,-61
1973,1,0,5,0,-5
1974,0,0,153,0,-153
1975,1,1,149,1876,1727
1976,1,0,57,0,-57
1977,1,0,84,0,-84
1978,1,1,529,1882,1353
1979,1,1,187,1236,1049
1980,1,0,5,0,-5
1981,1,0,187,0,-187
1982,0,0,73,0,-73
1983,1,1,644,1242,598
1984,0,0,15,0,-15
1985,0,0,24,0,-24
1986,0,0,2,0,-2
1987,0,0,125,0,-125
1988,1,0,1,0,-1
1989,1,1,709,1312,603
1990,0,0,46,0,-46
1991,0,0,21,0,-21
1992,0,0,65,0,-65
1993,0,0,19,0,-19
1994,1,1,729,2612,1883
1995,0,0,15,0,-15
1996,0,0,15,0,-15
1997,1,0,104,0,-104
1998,0,0,43,0,-43
1999,1,0,51,0,-51
2000,1,0,1,0,-1
2001,0,0,19,0,-19
2002,0,0,175,0,-175
2003,1,1,514,2675,2161
2004,1,1,126,1302,1176
2005,0,0,15,0,-15
2006,1,1,581,1555,974
2007,1,0,5,0,-5
2008,1,1,535,1401,866
2009,0,0,36,0,-36
2010,1,1,32,1212,1180
2011,0,0,41,0,-41
2012,1,0,32,0,-32
2013,0,0,114,0,-114
2014,0,0,4,0,-4
2015,1,1,424,1695,1271
2016,0,0,73,0,-73
2017,1,1,601,1270,669
2018,0,0,1,0,-1
2019,1,1,507,1206,699
2020,1,0,3,0,-3
2021,0,0,33,0,-33
2022,0,0,25,0,-25
2023,0,0,116,0,-116
2024,1,1,121,2035,1914
2025,0,0,7,0,-7
2026,0,0,120,0,-120
2027,0,0,57,0,-57
2028,1,0,28,0,-28
2029,1,0,108,0,-108
2030,1,0,16,0,-16
2031,1,1,471,1391,920
2032,1,1,423,1228,805
2033,1,1,185,1345,1160
2034,1,0,10,0,-10
2035,0,0,36,0,-36
2036,0,0,36,0,-36
2037,0,0,6,0,-6
2038,0,0,0,0,0
2039,0,0,46,0,-46
2040,1,1,838,1462,624
2041,1,0,3,0,-3
2042,1,0,15,0,-15
2043,1,0,1,0,-1
2044,1,0,43,0,-43
2045,1,1,74,3719,3645
2046,0,0,20,0,-20
2047,0,0,20,0,-20
2048,1,0,10,0,-10
2049,1,1,224,1549,1325
2050,0,0,12,0,-12
2051,0,0,40,0,-40
2052,1,0,87,0,-87
2053,1,1,521,1753,1232
2054,0,0,0,0,0
2055,0,0,11,0,-11
2056,1,0,52,0,-52
2057,1,1,1145,1882,737
2058,1,0,8,0,-8
2059,1,1,147,2743,2596
2060,1,1,340,1356,1016
2061,1,0,145,0,-145
2062,1,1,1538,1351,-187
2063,0,0,68,0,-68
2064,1,1,257,1329,1072
2065,1,1,246,1486,1240
2066,0,0,5,0,-5
2067,0,0,48,0,-48
2068,0,0,60,0,-60
2069,0,0,34,0,-34
2070,0,0,21,0,-21
2071,0,0,156,0,-156
2072,0,0,4,0,-4
2073,0,0,16,0,-16
2074,0,0,4,0,-4
2075,0,0,24,0,-24
2076,0,0,18,0,-18
2077,1,0,15,0,-15
2078,1,0,100,0,-100
2079,1,0,19,0,-19
2080,1,1,159,1831,1672
2081,1,0,44,0,-44
2082,1,0,46,0,-46
2083,1,0,98,0,-98
2084,0,0,11,0,-11
2085,1,1,575,1229,654
2086,0,0,10,0,-10
2087,1,1,402,1232,830
2088,1,0,9,0,-9
2089,1,0,89,0,-89
2090,0,0,29,0,-29
2091,0,0,27,0,-27
2092,0,0,35,0,-35
2093,1,1,138,1597,1459
2094,0,0,60,0,-60
2095,1,1,311,1207,896
2096,0,0,27,0,-27
2097,1,0,26,0,-26
2098,1,0,16,0,-16
2099,1,1,810,1287,477
2100,0,0,59,0,-59
2101,0,0,69,0,-69
2102,0,0,46,0,-46
2103,1,1,488,1427,939
2104,0,0,15,0,-15
2105,1,1,566,1480,914
2106,1,1,128,1362,1234
2107,1,1,178,1596,1418
2108,1,0,109,0,-109
2109,0,0,126,0,-126
2110,0,0,65,0,-65
2111,0,0,130,0,-130
2112,1,0,49,0,-49
2113,1,1,131,1633,1502
2114,0,0,86,0,-86
2115,0,0,79,0,-79
2116,1,0,12,0,-12
2117,0,0,2,0,-2
2118,0,0,65,0,-65
2119,1,1,857,1297,440
2120,1,1,48,1741,1693
2121,0,0,18,0,-18
2122,1,0,7,0,-7
2123,1,1,680,1379,699
2124,0,0,5,0,-5
2125,1,0,157,0,-157
2126,1,0,103,0,-103
2127,0,0,148,0,-148
2128,0,0,0,0,0
2129,1,1,302,1523,1221
2130,0,0,30,0,-30
2131,0,0,64,0,-64
2132,1,1,1091,2871,1780
2133,1,1,280,1342,1062
2134,1,1,136,1836,1700
2135,1,0,12,0,-12
2136,1,0,6,0,-6
2137,1,0,3,0,-3
2138,0,0,4,0,-4
2139,1,0,29,0,-29
2140,1,0,1,0,-1
2141,1,0,10,0,-10
2142,0,0,5,0,-5
2143,1,0,18,0,-18
2144,1,0,27,0,-27
2145,0,0,90,0,-90
2146,0,0,136,0,-136
2147,1,0,56,0,-56
2148,1,1,553,1784,1231
2149,1,1,496,1409,913
2150,1,0,44,0,-44
2151,0,0,33,0,-33
2152,0,0,273,0,-273
2153,1,0,33,0,-33
2154,1,1,351,1276,925
2155,1,0,29,0,-29
2156,1,0,44,0,-44
2157,1,0,60,0,-60
2158,1,1,715,1325,610
2159,1,1,73,1742,1669
2160,1,0,43,0,-43
2161,0,0,5,0,-5
2162,1,1,690,1757,1067
2163,0,0,4,0,-4
2164,0,0,46,0,-46
2165,1,0,17,0,-17
2166,1,1,959,1281,322
2167,1,1,144,1202,1058
2168,0,0,13,0,-13
2169,0,0,28,0,-28
2170,0,0,40,0,-40
2171,0,0,18,0,-18
2172,1,0,55,0,-55
2173,1,1,1052,1220,168
2174,0,0,27,0,-27
2175,0,0,3,0,-3
2176,1,1,782,1742,960
2177,1,1,339,1252,913
2178,0,0,7,0,-7
2179,1,1,1384,2238,854
2180,0,0,2,0,-2
2181,0,0,31,0,-31
2182,0,0,11,0,-11
2183,1,1,482,1751,1269
2184,1,1,991,1610,619
2185,0,0,150,0,-150
2186,0,0,104,0,-104
2187,1,1,668,1566,898
2188,1,1,780,1751,971
2189,0,0,367,0,-367
2190,0,0,68,0,-68
2191,1,1,1255,2375,1120
2192,1,1,86,1668,1582
2193,0,0,42,0,-42
2194,0,0,34,0,-34
2195,0,0,15,0,-15
2196,1,1,303,1310,1007
2197,0,0,70,0,-70
2198,0,0,3,0,-3
2199,1,1,1039,1586,547
2200,1,0,6,0,-6
2201,0,0,16,0,-16
2202,1,0,21,0,-21
2203,1,0,23,0,-23
2204,1,1,296,1795,1499
2205,0,0,18,0,-18
2206,1,1,166,1437,1271
2207,1,1,820,1308,488
2208,1,1,468,1889,1421
2209,1,0,19,0,-19
2210,0,0,33,0,-33
2211,0,0,9,0,-9
2212,1,1,720,1381,661
2213,1,0,15,0,-15
2214,1,0,8,0,-8
2215,0,0,48,0,-48
2216,0,0,53,0,-53
2217,1,0,11,0,-11
2218,1,1,350,1507,1157
2219,1,1,1125,1235,110
2220,1,1,658,1717,1059
2221,1,1,697,1889,1192
2222,1,0,129,0,-129
2223,0,0,21,0,-21
2224,1,0,104,0,-104
2225,1,1,1127,1258,131
2226,0,0,33,0,-33
2227,1,0,41,0,-41
2228,1,1,119,1425,1306
2229,1,0,2,0,-2
2230,0,0,5,0,-5
2231,1,0,33,0,-33
2232,1,0,72,0,-72
2233,1,1,379,1818,1439
2234,0,0,152,0,-152
2235,1,0,142,0,-142
2236,0,0,33,0,-33
2237,0,0,34,0,-34
2238,0,0,26,0,-26
2239,0,0,2,0,-2
2240,1,1,465,2631,2166
2241,1,1,1794,1265,-529
2242,1,1,729,1251,522
2243,0,0,84,0,-84
2244,1,0,110,0,-110
2245,1,1,990,1211,221
2246,0,0,73,0,-73
2247,0,0,63,0,-63
2248,1,1,338,1532,1194
2249,1,0,224,0,-224
2250,1,1,286,1259,973
2251,0,0,38,0,-38
2252,1,1,693,1249,556
2253,1,0,120,0,-120
2254,1,0,40,0,-40
2255,0,0,70,0,-70
2256,1,0,8,0,-8
2257,1,1,97,1213,1116
2258,1,1,1530,1231,-299
2259,0,0,44,0,-44
2260,1,0,73,0,-73
2261,1,1,1996,1432,-564
2262,1,1,720,1321,601
2263,1,1,114,3859,3745
2264,1,0,52,0,-52
2265,1,0,10,0,-10
2266,1,0,45,0,-45
2267,0,0,21,0,-21
2268,1,1,864,1870,1006
2269,1,1,625,1388,763
2270,0,0,76,0,-76
2271,0,0,23,0,-23
2272,0,0,182,0,-182
2273,1,1,1216,1505,289
2274,0,0,6,0,-6
2275,1,1,253,1496,1243
2276,0,0,159,0,-159
2277,0,0,24,0,-24
2278,1,1,149,1562,1413
2279,0,0,9,0,-9
2280,0,0,27,0,-27
2281,1,1,650,1394,744
2282,1,0,285,0,-285
2283,1,1,1223,2823,1600
2284,1,1,1276,1261,-15
2285,1,1,529,1403,874
2286,1,1,29,1397,1368
2287,1,0,12,0,-12
2288,0,0,66,0,-66
2289,1,0,142,0,-142
2290,1,1,636,1226,590
2291,1,1,223,1327,1104
2292,1,1,457,1760,1303
2293,1,1,53,1729,1676
2294,0,0,51,0,-51
2295,1,0,41,0,-41
2296,0,0,9,0,-9
2297,1,1,276,1249,973
2298,1,1,1044,1851,807
2299,0,0,28,0,-28
2300,1,0,86,0,-86
2301,1,0,50,0,-50
2302,0,0,48,0,-48
2303,1,0,11,0,-11
2304,1,1,71,2147,2076
2305,0,0,96,0,-96
2306,0,0,28,0,-28
2307,1,0,35,0,-35
2308,1,0,9,0,-9
2309,0,0,22,0,-22
2310,0,0,2,0,-2
2311,1,1,497,1537,1040
2312,1,1,352,2586,2234
2313,0,0,31,0,-31
2314,1,1,394,1589,1195
2315,0,0,8,0,-8
2316,1,1,659,1264,605
2317,1,1,275,1436,1161
2318,1,0,59,0,-59
2319,0,0,23,0,-23
2320,0,0,9,0,-9
2321,0,0,42,0,-42
2322,1,0,13,0,-13
2323,0,0,27,0,-27
2324,0,0,59,0,-59
2325,0,0,6,0,-6
2326,1,1,572,1513,941
2327,1,1,25,1290,1265
2328,1,0,51,0,-51
2329,0,0,7,0,-7
2330,1,1,340,1331,991
2331,0,0,108,0,-108
2332,0,0,22,0,-22
2333,1,1,38,1970,1932
2334,0,0,17,0,-17
2335,1,1,66,2511,2445
2336,0,0,25,0,-25
2337,1,0,21,0,-21
2338,0,0,15,0,-15
2339,1,0,135,0,-135
2340,0,0,68,0,-68
2341,1,1,513,1303,790
2342,1,1,1499,1383,-116
2343,0,0,51,0,-51
2344,1,0,108,0,-108
2345,1,1,238,1289,1051
2346,0,0,62,0,-62
2347,1,1,333,2069,1736
2348,0,0,3,0,-3
2349,0,0,2,0,-2
2350,1,0,133,0,-133
2351,0,0,47,0,-47
2352,0,0,40,0,-40
2353,1,1,458,1650,1192
2354,0,0,50,0,-50
2355,1,1,269,1439,1170
2356,1,1,135,1965,1830
2357,0,0,40,0,-40
2358,0,0,1,0,-1
2359,1,0,1,0,-1
2360,0,0,52,0,-52
2361,1,0,77,0,-77
2362,0,0,74,0,-74
2363,0,0,14,0,-14
2364,0,0,22,0,-22
2365,1,0,160,0,-160
2366,1,0,18,0,-18
2367,0,0,4,0,-4
2368,0,0,18,0,-18
2369,0,0,10,0,-10
2370,0,0,64,0,-64
2371,1,1,1732,1486,-246
2372,1,1,530,1278,748
2373,0,0,135,0,-135
2374,1,0,27,0,-27
2375,1,0,7,0,-7
2376,0,0,40,0,-40
2377,0,0,4,0,-4
2378,1,1,727,1407,680
2379,0,0,34,0,-34
2380,1,1,486,1423,937
2381,1,0,110,0,-110
2382,1,1,154,1289,1135
2383,1,1,867,1436,569
2384,1,1,408,1214,806
2385,0,0,42,0,-42
2386,0,0,29,0,-29
2387,1,0,36,0,-36
2388,0,0,72,0,-72
2389,1,0,4,0,-4
2390,1,1,70,1810,1740
2391,0,0,15,0,-15
2392,1,0,65,0,-65
2393,1,1,576,1579,1003
2394,1,1,207,2247,2040
2395,1,1,99,1232,1133
2396,0,0,35,0,-35
2397,1,0,25,0,-25
2398,1,0,16,0,-16
2399,1,1,379,4493,4114
2400,0,0,76,0,-76
2401,1,0,30,0,-30
2402,1,1,988,2409,1421
2403,0,0,32,0,-32
2404,0,0,35,0,-35
2405,1,1,128,1623,1495
2406,0,0,111,0,-111
2407,1,0,2,0,-2
2408,0,0,61,0,-61
2409,1,1,197,1766,1569
2410,1,0,97,0,-97
2411,1,0,23,0,-23
2412,1,1,2087,3606,1519
2413,1,0,4,0,-4
2414,1,1,541,1562,1021
2415,1,1,168,1458,1290
2416,1,0,50,0,-50
2417,1,0,50,0,-50
2418,0,0,22,0,-22
2419,0,0,75,0,-75
2420,0,0,108,0,-108
2421,0,0,13,0,-13
2422,1,1,70,1638,1568
2423,0,0,0,0,0
2424,1,0,106,0,-106
2425,1,1,321,1484,1163
2426,1,0,38,0,-38
2427,1,1,153,1264,1111
2428,1,0,12,0,-12
2429,1,1,1534,1210,-324
2430,0,0,37,0,-37
2431,1,1,86,1297,1211
2432,0,0,39,0,-39
2433,1,0,48,0,-48
2434,0,0,4,0,-4
2435,0,0,109,0,-109
2436,1,1,34,1219,1185
2437,1,1,986,1373,387
2438,1,1,381,3942,3561
2439,1,1,142,1662,1520
2440,1,0,58,0,-58
2441,1,1,316,1533,1217
2442,1,1,1896,1390,-506
2443,1,1,609,1383,774
2444,0,0,62,0,-62
2445,1,1,130,1588,1458
2446,1,1,154,1300,1146
2447,1,1,687,1812,1125
2448,0,0,21,0,-21
2449,0,0,3,0,-3
2450,0,0,13,0,-13
2451,1,0,63,0,-63
2452,1,1,110,1718,1608
2453,0,0,128,0,-128
2454,1,1,1677,1580,-97
2455,1,1,419,1627,1208
2456,1,0,72,0,-72
2457,1,0,121,0,-121
2458,0,0,6,0,-6
2459,1,0,83,0,-83
2460,1,0,5,0,-5
2461,1,1,324,1274,950
2462,1,1,152,1363,1211
2463,1,1,258,1383,1125
2464,0,0,12,0,-12
2465,1,1,415,2348,1933
2466,1,1,1517,1475,-42
2467,1,1,294,1334,1040
2468,1,1,1217,1479,262
2469,1,1,393,1359,966
2470,1,1,649,1235,586
2471,1,0,28,0,-28
2472,0,0,20,0,-20
2473,1,1,297,1444,1147
2474,0,0,82,0,-82
2475,0,0,4,0,-4
2476,0,0,7,0,-7
2477,1,0,40,0,-40
2478,1,0,72,0,-72
2479,1,1,62,1221,1159
2480,0,0,17,0,-17
2481,1,0,41,0,-41
2482,1,1,468,1383,915
2483,0,0,7,0,-7
2484,0,0,87,0,-87
2485,0,0,50,0,-50
2486,1,0,148,0,-148
2487,1,1,192,1493,1301
2488,0,0,46,0,-46
2489,0,0,82,0,-82
2490,1,0,22,0,-22
2491,0,0,7,0,-7
2492,1,0,94,0,-94
2493,0,0,11,0,-11
2494,1,0,18,0,-18
2495,1,1,835,1225,390
2496,1,1,1204,1386,182
2497,1,1,348,2197,1849
2498,0,0,14,0,-14
2499,1,0,118,0,-118
2500,1,1,159,2301,2142
2501,0,0,69,0,-69
2502,1,0,30,0,-30
2503,0,0,41,0,-41
2504,1,0,58,0,-58
2505,1,1,200,1432,1232
2506,1,1,441,1233,792
2507,1,1,376,1671,1295
2508,1,0,1,0,-1
2509,1,0,1,0,-1
2510,1,1,381,1228,847
2511,1,0,45,0,-45
2512,1,0,81,0,-81
2513,1,0,186,0,-186
2514,1,0,0,0,0
2515,1,0,3,0,-3
2516,1,0,65,0,-65
2517,1,1,83,1541,1458
2518,1,1,360,1450,1090
2519,0,0,17,0,-17
2520,1,1,438,1330,892
2521,1,1,640,1599,959
2522,0,0,47,0,-47
2523,1,0,26,0,-26
2524,0,0,7,0,-7
2525,1,0,200,0,-200
2526,0,0,10,0,-10
2527,1,0,210,0,-210
2528,1,0,116,0,-116
2529,1,1,58,1311,1253
2530,0,0,105,0,-105
2531,0,0,18,0,-18
2532,0,0,2,0,-2
2533,1,0,50,0,-50
2534,1,0,14,0,-14
2535,1,0,29,0,-29
2536,0,0,18,0,-18
2537,0,0,193,0,-193
2538,1,1,153,2152,1999
2539,1,0,4,0,-4
2540,1,0,16,0,-16
2541,0,0,24,0,-24
2542,0,0,170,0,-170
2543,1,1,124,1627,1503
2544,1,1,95,2026,1931
2545,1,1,168,1458,1290
2546,0,0,62,0,-62
2547,1,1,922,2170,1248
2548,1,1,1431,2064,633
2549,1,0,9,0,-9
2550,1,1,1589,1683,94
2551,1,0,68,0,-68
2552,1,1,66,1256,1190
2553,1,1,2235,1228,-1007
2554,1,1,412,1259,847
2555,1,0,46,0,-46
2556,1,1,543,1969,1426
2557,0,0,47,0,-47
2558,0,0,162,0,-162
2559,0,0,21,0,-21
2560,0,0,160,0,-160
2561,0,0,69,0,-69
2562,1,0,24,0,-24
2563,1,1,882,2065,1183
2564,0,0,9,0,-9
2565,0,0,41,0,-41
2566,1,0,75,0,-75
2567,1,0,29,0,-29
2568,1,0,27,0,-27
2569,0,0,3,0,-3
2570,0,0,40,0,-40
2571,1,1,366,1224,858
2572,1,0,45,0,-45
2573,1,1,478,1374,896
2574,1,0,16,0,-16
2575,1,0,25,0,-25
2576,1,1,733,1215,482
2577,1,1,340,1405,1065
2578,0,0,2,0,-2
2579,1,1,105,1241,1136
2580,0,0,5,0,-5
2581,0,0,73,0,-73
2582,0,0,90,0,-90
2583,1,0,47,0,-47
2584,1,0,8,0,-8
2585,1,1,3643,2629,-1014
2586,1,1,518,1318,800
2587,1,1,259,1723,1464
2588,0,0,3,0,-3
2589,1,0,5,0,-5
2590,0,0,1,0,-1
2591,0,0,11,0,-11
2592,1,1,797,1574,777
2593,0,0,9,0,-9
2594,0,0,213,0,-213
2595,0,0,32,0,-32
2596,1,0,25,0,-25
2597,1,1,199,1208,1009
2598,0,0,0,0,0
2599,1,1,47,1409,1362
2600,0,0,4,0,-4
2601,1,0,164,0,-164
2602,1,1,559,1293,734
2603,1,1,202,1247,1045
2604,1,1,444,1269,825
2605,1,1,536,1407,871
2606,1,0,0,0,0
2607,0,0,26,0,-26
2608,1,0,53,0,-53
2609,0,0,50,0,-50
2610,1,1,416,1576,1160
2611,1,1,286,1358,1072
2612,1,0,76,0,-76
2613,0,0,42,0,-42
2614,1,0,2,0,-2
2615,0,0,21,0,-21
2616,1,0,73,0,-73
2617,1,1,257,2643,2386
2618,1,0,16,0,-16
2619,1,1,440,1245,805
2620,1,1,324,2154,1830
2621,0,0,27,0,-27
2622,1,1,1308,1225,-83
2623,0,0,43,0,-43
2624,0,0,2,0,-2
2625,0,0,5,0,-5
2626,0,0,68,0,-68
2627,0,0,19,0,-19
2628,0,0,23,0,-23
2629,0,0,72,0,-72
2630,1,0,69,0,-69
2631,1,1,1428,1236,-192
2632,1,1,307,1682,1375
2633,0,0,12,0,-12
2634,1,0,68,0,-68
2635,0,0,14,0,-14
2636,0,0,2,0,-2
2637,1,0,19,0,-19
2638,1,1,672,1295,623
2639,1,1,1031,7775,6744
2640,1,0,87,0,-87
2641,1,1,202,2844,2642
2642,1,0,105,0,-105
2643,1,1,783,1365,582
2644,0,0,48,0,-48
2645,1,1,407,1208,801
2646,0,0,62,0,-62
2647,1,1,324,1292,968
2648,1,1,519,1230,711
2649,0,0,9,0,-9
2650,0,0,8,0,-8
2651,1,1,6,1970,1964
2652,0,0,59,0,-59
2653,1,1,288,1350,1062
2654,1,1,1263,1378,115
2655,0,0,7,0,-7
2656,0,0,47,0,-47
2657,0,0,44,0,-44
2658,0,0,25,0,-25
2659,0,0,14,0,-14
2660,1,1,2104,1286,-818
2661,0,0,98,0,-98
2662,1,0,7,0,-7
2663,1,0,57,0,-57
2664,1,1,524,1725,1201
2665,1,0,0,0,0
2666,0,0,57,0,-57
2667,0,0,31,0,-31
2668,1,1,72,1673,1601
2669,1,0,89,0,-89
2670,0,0,34,0,-34
2671,0,0,30,0,-30
2672,1,0,33,0,-33
2673,0,0,20,0,-20
2674,1,0,60,0,-60
2675,0,0,4,0,-4
2676,1,1,865,1207,342
2677,1,0,62,0,-62
2678,1,0,53,0,-53
2679,1,1,49,1222,1173
2680,1,0,25,0,-25
2681,1,0,42,0,-42
2682,0,0,36,0,-36
2683,1,0,23,0,-23
2684,0,0,0,0,0
2685,1,1,186,1295,1109
2686,0,0,27,0,-27
2687,0,0,27,0,-27
2688,0,0,53,0,-53
2689,1,0,4,0,-4
2690,1,1,74,1284,1210
2691,1,0,16,0,-16
2692,1,0,40,0,-40
2693,0,0,54,0,-54
2694,0,0,48,0,-48
2695,1,1,716,3284,2568
2696,1,0,139,0,-139
2697,1,0,32,0,-32
2698,1,1,368,1376,1008
2699,0,0,155,0,-155
2700,1,1,266,1354,1088
2701,1,1,616,1277,661
2702,1,0,27,0,-27
2703,1,1,442,1756,1314
2704,1,0,6,0,-6
2705,0,0,90,0,-90
2706,1,0,90,0,-90
2707,1,0,73,0,-73
2708,1,0,15,0,-15
2709,0,0,80,0,-80
2710,0,0,64,0,-64
2711,0,0,183,0,-183
2712,0,0,12,0,-12
2713,1,1,266,1203,937
2714,1,0,7,0,-7
2715,1,1,41,1598,1557
2716,1,0,111,0,-111
2717,1,1,112,1221,1109
2718,1,0,35,0,-35
2719,1,0,41,0,-41
2720,0,0,23,0,-23
2721,1,1,511,1415,904
2722,0,0,17,0,-17
2723,0,0,20,0,-20
2724,1,0,66,0,-66
2725,0,0,12,0,-12
2726,1,0,107,0,-107
2727,0,0,73,0,-73
2728,0,0,5,0,-5
2729,0,0,8,0,-8
2730,0,0,35,0,-35
2731,1,1,215,1226,1011
2732,1,0,4,0,-4
2733,1,1,1503,1319,-184
2734,0,0,69,0,-69
2735,1,0,0,0,0
2736,1,0,162,0,-162
2737,1,0,24,0,-24
2738,1,0,43,0,-43
2739,1,0,9,0,-9
2740,1,0,9,0,-9
2741,0,0,37,0,-37
2742,0,0,35,0,-35
2743,1,1,37,1228,1191
2744,0,0,21,0,-21
2745,1,0,11,0,-11
2746,1,0,60,0,-60
2747,1,1,1536,1222,-314
2748,0,0,36,0,-36
2749,0,0,10,0,-10
2750,1,0,4,0,-4
2751,1,1,766,1447,681
2752,0,0,97,0,-97
2753,0,0,2,0,-2
2754,1,0,213,0,-213
2755,1,0,113,0,-113
2756,0,0,4,0,-4
2757,0,0,12,0,-12
2758,1,0,47,0,-47
2759,0,0,8,0,-8
2760,1,0,7,0,-7
2761,0,0,66,0,-66
2762,0,0,115,0,-115
2763,1,1,174,1333,1159
2764,1,0,18,0,-18
2765,0,0,8,0,-8
2766,1,0,8,0,-8
2767,1,1,474,1713,1239
2768,1,0,3,0,-3
2769,1,1,257,1286,1029
2770,0,0,2,0,-2
2771,0,0,39,0,-39
2772,0,0,70,0,-70
2773,1,1,40,1570,1530
2774,1,1,1510,1601,91
2775,0,0,33,0,-33
2776,1,0,4,0,-4
2777,1,1,1144,1319,175
2778,1,1,1493,1367,-126
2779,0,0,218,0,-218
2780,1,0,167,0,-167
2781,1,0,46,0,-46
2782,1,1,202,1257,1055
2783,1,0,109,0,-109
2784,0,0,36,0,-36
2785,0,0,89,0,-89
2786,1,1,772,2155,1383
2787,0,0,11,0,-11
2788,1,0,202,0,-202
2789,1,1,2348,1994,-354
2790,0,0,11,0,-11
2791,1,1,1955,1806,-149
2792,1,1,1367,1316,-51
2793,0,0,36,0,-36
2794,1,1,197,2643,2446
2795,1,1,452,1700,1248
2796,0,0,53,0,-53
2797,0,0,56,0,-56
2798,1,1,598,1221,623
2799,1,0,87,0,-87
2800,1,1,132,1701,1569
2801,0,0,31,0,-31
2802,0,0,20,0,-20
2803,0,0,1,0,-1
2804,1,1,64,1329,1265
2805,1,0,2,0,-2
2806,1,1,362,2577,2215
2807,1,0,3,0,-3
2808,1,1,2070,1245,-825
2809,0,0,95,0,-95
2810,1,0,158,0,-158
2811,1,1,290,1220,930
2812,1,1,1119,1200,81
2813,1,1,34,1293,1259
2814,1,1,300,1325,1025
2815,1,1,478,1486,1008
2816,0,0,95,0,-95
2817,0,0,39,0,-39
2818,0,0,23,0,-23
2819,1,0,96,0,-96
2820,1,1,404,1239,835
2821,0,0,13,0,-13
2822,1,0,85,0,-85
2823,0,0,23,0,-23
2824,0,0,24,0,-24
2825,1,1,274,1378,1104
2826,0,0,121,0,-121
2827,0,0,26,0,-26
2828,1,0,22,0,-22
2829,0,0,29,0,-29
2830,1,0,9,0,-9
2831,1,1,45,1775,1730
2832,0,0,19,0,-19
2833,0,0,99,0,-99
2834,1,0,9,0,-9
2835,1,1,695,2082,1387
2836,0,0,17,0,-17
2837,0,0,104,0,-104
2838,1,1,281,2141,1860
2839,0,0,0,0,0
2840,1,0,6,0,-6
2841,1,1,103,1303,1200
2842,1,0,16,0,-16
2843,0,0,18,0,-18
2844,0,0,38,0,-38
2845,0,0,96,0,-96
2846,1,1,174,2654,2480
2847,1,0,146,0,-146
2848,1,1,534,1373,839
2849,1,0,32,0,-32
2850,1,1,1961,1447,-514
2851,0,0,2,0,-2
2852,1,1,192,1525,1333
2853,0,0,178,0,-178
2854,1,1,149,1535,1386
2855,0,0,45,0,-45
2856,0,0,0,0,0
2857,0,0,53,0,-53
2858,1,0,0,0,0
2859,0,0,70,0,-70
2860,1,0,1,0,-1
2861,1,0,76,0,-76
2862,0,0,62,0,-62
2863,0,0,188,0,-188
2864,0,0,34,0,-34
2865,1,1,1068,1220,152
2866,1,1,153,1936,1783
2867,0,0,39,0,-39
2868,1,0,37,0,-37
2869,1,0,49,0,-49
2870,1,0,23,0,-23
2871,1,0,7,0,-7
2872,1,1,398,1332,934
2873,0,0,30,0,-30
2874,1,1,66,1782,1716
2875,1,0,1,0,-1
2876,1,0,40,0,-40
2877,0,0,43,0,-43
2878,1,1,371,1454,1083
2879,1,1,414,1715,1301
2880,0,0,8,0,-8
2881,1,1,240,1678,1438
2882,1,0,12,0,-12
2883,0,0,61,0,-61
2884,1,0,9,0,-9
2885,1,1,28,2570,2542
2886,1,1,460,2028,1568
2887,1,1,917,1209,292
2888,1,1,67,1240,1173
2889,1,0,89,0,-89
2890,1,0,28,0,-28
2891,1,1,396,1306,910
2892,1,0,89,0,-89
2893,0,0,17,0,-17
2894,0,0,35,0,-35
2895,1,1,537,2348,1811
2896,0,0,82,0,-82
2897,1,0,2,0,-2
2898,1,0,9,0,-9
2899,1,1,983,1425,442
2900,0,0,2,0,-2
2901,0,0,74,0,-74
2902,1,0,18,0,-18
2903,1,1,773,1750,977
2904,0,0,36,0,-36
2905,1,1,712,1232,520
2906,0,0,9,0,-9
2907,1,0,98,0,-98
2908,0,0,30,0,-30
2909,1,1,337,1208,871
2910,1,0,75,0,-75
2911,0,0,57,0,-57
2912,1,0,10,0,-10
2913,0,0,47,0,-47
2914,0,0,6,0,-6
2915,1,0,1,0,-1
2916,0,0,13,0,-13
2917,0,0,40,0,-40
2918,1,1,431,1675,1244
2919,1,0,20,0,-20
2920,1,0,3,0,-3
2921,0,0,5,0,-5
2922,1,1,360,1378,1018
2923,1,0,11,0,-11
2924,0,0,58,0,-58
2925,1,0,29,0,-29
2926,0,0,43,0,-43
2927,1,1,277,1365,1088
2928,0,0,21,0,-21
2929,0,0,48,0,-48
2930,0,0,27,0,-27
2931,1,1,210,1201,991
2932,1,0,28,0,-28
2933,0,0,30,0,-30
2934,1,0,42,0,-42
2935,1,0,19,0,-19
2936,1,1,836,1202,366
2937,0,0,4,0,-4
2938,1,1,250,1684,1434
2939,0,0,7,0,-7
2940,0,0,17,0,-17
2941,0,0,1,0,-1
2942,1,0,5,0,-5
2943,1,1,643,1319,676
2944,1,1,500,1974,1474
2945,1,1,355,1966,1611
2946,1,0,23,0,-23
2947,0,0,25,0,-25
2948,0,0,24,0,-24
2949,0,0,90,0,-90
2950,1,0,19,0,-19
2951,0,0,29,0,-29
2952,1,0,2,0,-2
2953,1,1,579,2142,1563
2954,1,1,213,1653,1440
2955,0,0,54,0,-54
2956,1,1,595,1955,1360
2957,0,0,7,0,-7
2958,0,0,94,0,-94
2959,1,1,1935,1257,-678
2960,1,1,349,1353,1004
2961,1,1,214,1437,1223
2962,0,0,15,0,-15
2963,0,0,10,0,-10
2964,0,0,18,0,-18
2965,1,0,15,0,-15
2966,0,0,17,0,-17
2967,1,0,67,0,-67
2968,1,0,110,0,-110
2969,1,1,243,2073,1830
2970,0,0,22,0,-22
2971,1,1,1058,1669,611
2972,1,1,204,1251,1047
2973,1,0,7,0,-7
2974,1,1,47,1454,1407
2975,1,0,3,0,-3
2976,0,0,20,0,-20
2977,1,1,564,1681,1117
2978,1,0,110,0,-110
2979,1,0,2,0,-2
2980,0,0,17,0,-17
2981,1,0,4,0,-4
2982,0,0,23,0,-23
2983,1,1,517,1300,783
2984,1,0,194,0,-194
2985,0,0,18,0,-18
2986,1,0,2,0,-2
2987,1,1,982,2171,1189
2988,1,1,413,1290,877
2989,0,0,39,0,-39
2990,1,1,503,1253,750
2991,1,0,11,0,-11
2992,1,1,703,2164,1461
2993,1,0,31,0,-31
2994,0,0,10,0,-10
2995,0,0,39,0,-39
2996,1,1,405,2263,1858
2997,0,0,4,0,-4
2998,0,0,29,0,-29
2999,1,1,132,1470,1338
3000,0,0,44,0,-44
3001,0,0,148,0,-148
3002,1,1,33,1421,1388
3003,1,0,23,0,-23
3004,0,0,25,0,-25
3005,1,1,234,1785,1551
3006,1,0,93,0,-93
3007,1,0,13,0,-13
3008,0,0,3,0,-3
3009,1,0,194,0,-194
3010,1,0,43,0,-43
3011,1,0,68,0,-68
3012,0,0,23,0,-23
3013,1,1,242,1291,1049
3014,0,0,14,0,-14
3015,1,0,5,0,-5
3016,1,0,16,0,-16
3017,1,1,294,1837,1543
3018,0,0,31,0,-31
3019,0,0,15,0,-15
3020,1,0,45,0,-45
3021,0,0,12,0,-12
3022,0,0,55,0,-55
3023,1,1,246,1487,1241
3024,1,0,77,0,-77
3025,0,0,15,0,-15
3026,0,0,71,0,-71
3027,0,0,103,0,-103
3028,0,0,23,0,-23
3029,1,1,1955,1548,-407
3030,1,1,191,1247,1056
3031,0,0,114,0,-114
3032,1,1,1910,1247,-663
3033,1,1,136,1556,1420
3034,1,1,930,2473,1543
3035,1,0,22,0,-22
3036,1,1,138,1965,1827
3037,1,1,679,1201,522
3038,1,1,816,1365,549
3039,1,1,470,1220,750
3040,0,0,43,0,-43
3041,1,0,77,0,-77
3042,1,1,156,1325,1169
3043,0,0,31,0,-31
3044,1,0,26,0,-26
3045,1,1,1094,1359,265
3046,1,0,66,0,-66
3047,1,1,867,1348,481
3048,1,0,52,0,-52
3049,0,0,27,0,-27
3050,0,0,1,0,-1
3051,1,0,17,0,-17
3052,1,1,721,1279,558
3053,1,1,73,1224,1151
3054,1,0,5,0,-5
3055,0,0,11,0,-11
3056,0,0,72,0,-72
3057,0,0,25,0,-25
3058,1,0,281,0,-281
3059,0,0,5,0,-5
3060,0,0,24,0,-24
3061,0,0,65,0,-65
3062,0,0,37,0,-37
3063,1,1,921,1282,361
3064,0,0,30,0,-30
3065,1,0,47,0,-47
3066,0,0,80,0,-80
3067,0,0,67,0,-67
3068,0,0,31,0,-31
3069,0,0,65,0,-65
3070,1,0,66,0,-66
3071,0,0,41,0,-41
3072,1,0,52,0,-52
3073,0,0,86,0,-86
3074,0,0,74,0,-74
3075,0,0,71,0,-71
3076,0,0,16,0,-16
3077,1,0,14,0,-14
3078,0,0,11,0,-11
3079,1,0,67,0,-67
3080,1,1,666,1244,578
3081,1,0,21,0,-21
3082,1,0,100,0,-100
3083,1,0,24,0,-24
3084,1,1,311,1458,1147
3085,0,0,0,0,0
3086,1,1,542,1374,832
3087,0,0,35,0,-35
3088,0,0,122,0,-122
3089,0,0,5,0,-5
3090,1,0,133,0,-133
3091,0,0,92,0,-92
3092,0,0,153,0,-153
3093,1,1,276,1234,958
3094,1,0,29,0,-29
3095,0,0,33,0,-33
3096,0,0,31,0,-31
3097,1,0,11,0,-11
3098,1,1,218,1534,1316
3099,0,0,17,0,-17
3100,1,1,190,2309,2119
3101,1,1,279,1295,1016
3102,0,0,91,0,-91
3103,1,1,110,1294,1184
3104,1,0,64,0,-64
3105,1,0,56,0,-56
3106,0,0,80,0,-80
3107,1,1,1142,1352,210
3108,1,0,43,0,-43
3109,0,0,30,0,-30
3110,1,1,87,1227,1140
3111,1,0,166,0,-166
3112,1,1,181,2418,2237
3113,1,1,308,1252,944
3114,0,0,72,0,-72
3115,0,0,66,0,-66
3116,1,1,293,1962,1669
3117,0,0,29,0,-29
3118,1,1,500,2004,1504
3119,1,0,55,0,-55
3120,0,0,38,0,-38
3121,1,1,462,1464,1002
3122,1,1,89,1367,1278
3123,1,0,165,0,-165
3124,1,0,12,0,-12
3125,0,0,31,0,-31
3126,1,1,454,1277,823
3127,0,0,226,0,-226
3128,1,1,44,3513,3469
3129,0,0,1,0,-1
3130,1,1,607,1237,630
3131,1,1,208,1808,1600
3132,0,0,2,0,-2
3133,0,0,43,0,-43
3134,1,1,608,1801,1193
3135,0,0,36,0,-36
3136,1,0,16,0,-16
3137,1,0,51,0,-51
3138,1,1,121,2429,2308
3139,0,0,20,0,-20
3140,1,0,28,0,-28
3141,0,0,37,0,-37
3142,1,1,1999,2518,519
3143,1,1,729,1268,539
3144,1,1,35,1565,1530
3145,0,0,20,0,-20
3146,1,0,72,0,-72
3147,1,0,33,0,-33
3148,1,1,109,1203,1094
3149,1,0,41,0,-41
3150,0,0,3,0,-3
3151,1,1,240,1464,1224
3152,1,1,667,1989,1322
3153,1,1,858,1765,907
3154,0,0,34,0,-34
3155,1,1,871,1237,366
3156,1,0,8,0,-8
3157,1,0,21,0,-21
3158,0,0,21,0,-21
3159,0,0,68,0,-68
3160,1,0,37,0,-37
3161,1,1,107,1417,1310
3162,1,1,835,1491,656
3163,1,0,23,0,-23
3164,1,1,205,1279,1074
3165,1,0,6,0,-6
3166,1,1,335,1374,1039
3167,1,0,90,0,-90
3168,1,0,28,0,-28
3169,1,1,251,2195,1944
3170,1,0,66,0,-66
3171,1,0,20,0,-20
3172,0,0,38,0,-38
3173,0,0,64,0,-64
3174,0,0,6,0,-6
3175,1,1,2246,1391,-855
3176,0,0,5,0,-5
3177,1,0,15,0,-15
3178,1,1,562,1266,704
3179,1,0,22,0,-22
3180,1,1,453,1318,865
3181,0,0,6,0,-6
3182,1,1,100,1284,1184
3183,1,0,38,0,-38
3184,1,1,114,1445,1331
3185,0,0,5,0,-5
3186,1,1,253,1298,1045
3187,1,0,32,0,-32
3188,0,0,85,0,-85
3189,1,0,33,0,-33
3190,0,0,72,0,-72
3191,1,1,513,2720,2207
3192,0,0,35,0,-35
3193,1,0,21,0,-21
3194,1,1,554,1332,778
3195,1,0,22,0,-22
3196,0,0,58,0,-58
3197,1,1,89,1519,1430
3198,0,0,78,0,-78
3199,0,0,19,0,-19
3200,1,0,6,0,-6
3201,0,0,73,0,-73
3202,1,1,262,1592,1330
3203,0,0,67,0,-67
3204,1,1,682,1623,941
3205,1,1,155,1982,1827
3206,0,0,52,0,-52
3207,0,0,6,0,-6
3208,1,1,43,1330,1287
3209,0,0,30,0,-30
3210,1,1,115,1234,1119
3211,1,0,2,0,-2
3212,0,0,92,0,-92
3213,0,0,130,0,-130
3214,1,0,24,0,-24
3215,1,0,26,0,-26
3216,1,0,5,0,-5
3217,1,1,186,1789,1603
3218,0,0,89,0,-89
3219,0,0,26,0,-26
3220,0,0,8,0,-8
3221,0,0,42,0,-42
3222,0,0,4,0,-4
3223,0,0,172,0,-172
3224,0,0,11,0,-11
3225,0,0,0,0,0
3226,0,0,17,0,-17
3227,1,0,27,0,-27
3228,1,0,42,0,-42
3229,1,1,67,1362,1295
3230,1,1,539,2129,1590
3231,1,1,415,1402,987
3232,1,0,9,0,-9
3233,1,1,630,1510,880
3234,1,0,4,0,-4
3235,0,0,77,0,-77
3236,1,1,576,1887,1311
3237,0,0,3,0,-3
3238,1,0,3,0,-3
3239,1,0,44,0,-44
3240,1,0,68,0,-68
3241,1,1,221,1646,1425
3242,1,1,48,2349,2301
3243,1,1,591,1422,831
3244,1,1,67,1209,1142
3245,0,0,35,0,-35
3246,0,0,99,0,-99
3247,1,1,664,1269,605
3248,0,0,13,0,-13
3249,1,0,119,0,-119
3250,0,0,25,0,-25
3251,1,1,272,1310,1038
3252,0,0,140,0,-140
3253,0,0,80,0,-80
3254,0,0,115,0,-115
3255,1,1,269,1666,1397
3256,0,0,74,0,-74
3257,1,0,13,0,-13
3258,0,0,46,0,-46
3259,0,0,57,0,-57
3260,1,0,29,0,-29
3261,1,1,99,1694,1595
3262,0,0,87,0,-87
3263,1,0,270,0,-270
3264,0,0,25,0,-25
3265,1,0,140,0,-140
3266,0,0,46,0,-46
3267,0,0,0,0,0
3268,0,0,49,0,-49
3269,1,1,949,2022,1073
3270,0,0,16,0,-16
3271,1,1,606,2904,2298
3272,0,0,2,0,-2
3273,1,1,469,1675,1206
3274,0,0,222,0,-222
3275,1,1,337,1222,885
3276,0,0,61,0,-61
3277,1,0,24,0,-24
3278,0,0,5,0,-5
3279,0,0,66,0,-66
3280,1,0,116,0,-116
3281,1,0,25,0,-25
3282,1,1,1536,1411,-125
3283,1,1,245,1223,978
3284,1,1,49,1204,1155
3285,1,1,71,2409,2338
3286,0,0,13,0,-13
3287,0,0,41,0,-41
3288,1,1,432,1268,836
3289,1,0,34,0,-34
3290,0,0,57,0,-57
3291,1,0,56,0,-56
3292,1,1,214,1710,1496
3293,0,0,249,0,-249
3294,0,0,24,0,-24
3295,1,1,1245,1408,163
3296,1,0,17,0,-17
3297,1,1,97,1336,1239
3298,1,1,745,1241,496
3299,1,1,685,1359,674
3300,1,1,1159,3586,2427
3301,1,1,119,1614,1495
3302,1,0,29,0,-29
3303,1,1,353,1942,1589
3304,1,1,305,1302,997
3305,1,0,78,0,-78
3306,1,0,28,0,-28
3307,1,0,3,0,-3
3308,0,0,9,0,-9
3309,0,0,18,0,-18
3310,0,0,17,0,-17
3311,0,0,11,0,-11
3312,1,1,139,1331,1192
3313,1,0,18,0,-18
3314,1,0,4,0,-4
3315,1,1,2689,1626,-1063
3316,1,1,324,1308,984
3317,0,0,15,0,-15
3318,1,1,1110,1381,271
3319,0,0,64,0,-64
3320,0,0,11,0,-11
3321,1,0,2,0,-2
3322,1,1,56,1599,1543
3323,1,0,10,0,-10
3324,1,1,613,1209,596
3325,0,0,40,0,-40
3326,1,1,392,1325,933
3327,1,1,598,1900,1302
3328,1,0,44,0,-44
3329,1,1,189,1351,1162
3330,0,0,35,0,-35
3331,0,0,42,0,-42
3332,0,0,22,0,-22
3333,1,0,80,0,-80
3334,0,0,60,0,-60
3335,1,0,2,0,-2
3336,1,0,0,0,0
3337,1,1,91,1295,1204
3338,1,0,37,0,-37
3339,0,0,1,0,-1
3340,1,0,70,0,-70
3341,1,0,45,0,-45
3342,1,0,17,0,-17
3343,1,0,155,0,-155
3344,1,0,38,0,-38
3345,1,1,324,1348,1024
3346,1,1,939,1699,760
3347,1,1,583,1283,700
3348,1,1,286,1307,1021
3349,0,0,48,0,-48
3350,0,0,172,0,-172
3351,1,0,61,0,-61
3352,1,0,44,0,-44
3353,1,0,10,0,-10
3354,0,0,31,0,-31
3355,0,0,182,0,-182
3356,1,0,91,0,-91
3357,1,0,2,0,-2
3358,1,0,95,0,-95
3359,0,0,0,0,0
3360,1,1,881,1440,559
3361,0,0,140,0,-140
3362,0,0,58,0,-58
3363,0,0,6,0,-6
3364,1,0,41,0,-41
3365,0,0,32,0,-32
3366,0,0,41,0,-41
3367,1,1,554,2132,1578
3368,1,0,36,0,-36
3369,1,0,101,0,-101
3370,0,0,24,0,-24
3371,0,0,67,0,-67
3372,1,0,35,0,-35
3373,1,1,159,2653,2494
3374,1,0,58,0,-58
3375,1,1,87,1341,1254
3376,0,0,77,0,-77
3377,1,1,807,1384,577
3378,1,1,446,1614,1168
3379,0,0,108,0,-108
3380,0,0,36,0,-36
3381,0,0,3,0,-3
3382,1,0,12,0,-12
3383,1,0,28,0,-28
3384,1,1,707,1752,1045
3385,1,1,479,1248,769
3386,1,1,867,1509,642
3387,1,0,60,0,-60
3388,1,0,110,0,-110
3389,1,0,73,0,-73
3390,1,0,62,0,-62
3391,0,0,6,0,-6
3392,0,0,44,0,-44
3393,1,0,125,0,-125
3394,1,1,1162,1200,38
3395,1,0,38,0,-38
3396,1,1,676,1276,600
3397,1,0,9,0,-9
3398,0,0,84,0,-84
3399,1,1,365,1584,1219
3400,1,0,111,0,-111
3401,1,0,26,0,-26
3402,1,0,45,0,-45
3403,1,0,62,0,-62
3404,1,0,19,0,-19
3405,0,0,147,0,-147
3406,1,0,0,0,0
3407,1,0,115,0,-115
3408,1,1,214,1631,1417
3409,0,0,22,0,-22
3410,1,1,786,2405,1619
3411,0,0,58,0,-58
3412,0,0,14,0,-14
3413,1,1,372,1362,990
3414,1,1,288,1316,1028
3415,0,0,47,0,-47
3416,1,0,64,0,-64
3417,0,0,3,0,-3
3418,0,0,18,0,-18
3419,0,0,138,0,-138
3420,0,0,7,0,-7
3421,1,1,1762,2484,722
3422,0,0,47,0,-47
3423,0,0,54,0,-54
3424,1,1,46,1252,1206
3425,0,0,6,0,-6
3426,1,0,76,0,-76
3427,1,1,111,2119,2008
3428,0,0,94,0,-94
3429,1,1,659,1257,598
3430,1,1,36,1320,1284
3431,1,1,716,1206,490
3432,1,0,19,0,-19
3433,1,0,75,0,-75
3434,0,0,11,0,-11
3435,0,0,6,0,-6
3436,1,0,2,0,-2
3437,1,1,108,1312,1204
3438,0,0,69,0,-69
3439,0,0,53,0,-53
3440,0,0,67,0,-67
3441,0,0,44,0,-44
3442,1,0,73,0,-73
3443,0,0,65,0,-65
3444,1,0,88,0,-88
3445,1,0,32,0,-32
3446,1,1,364,1276,912
3447,1,0,129,0,-129
3448,1,0,18,0,-18
3449,1,1,361,1242,881
3450,0,0,116,0,-116
3451,1,0,134,0,-134
3452,0,0,4,0,-4
3453,0,0,20,0,-20
3454,0,0,24,0,-24
3455,0,0,149,0,-149
3456,0,0,6,0,-6
3457,0,0,48,0,-48
3458,0,0,69,0,-69
3459,0,0,15,0,-15
3460,0,0,73,0,-73
3461,1,0,23,0,-23
3462,1,1,1406,3045,1639
3463,0,0,72,0,-72
3464,0,0,26,0,-26
3465,1,0,7,0,-7
3466,1,0,26,0,-26
3467,0,0,35,0,-35
3468,1,1,270,1232,962
3469,0,0,137,0,-137
3470,0,0,31,0,-31
3471,0,0,15,0,-15
3472,0,0,37,0,-37
3473,0,0,11,0,-11
3474,1,1,263,1802,1539
3475,1,0,51,0,-51
3476,1,0,163,0,-163
3477,1,0,12,0,-12
3478,1,1,39,2031,1992
3479,0,0,115,0,-115
3480,1,1,721,1372,651
3481,1,0,9,0,-9
3482,1,0,6,0,-6
3483,1,0,88,0,-88
3484,0,0,0,0,0
3485,1,0,118,0,-118
3486,1,0,4,0,-4
3487,1,1,702,1459,757
3488,0,0,46,0,-46
3489,0,0,94,0,-94
3490,1,0,35,0,-35
3491,1,1,761,1384,623
3492,0,0,19,0,-19
3493,0,0,6,0,-6
3494,1,1,1171,1789,618
3495,0,0,64,0,-64
3496,1,1,110,1264,1154
3497,1,0,38,0,-38
3498,0,0,89,0,-89
3499,1,0,256,0,-256
3500,1,1,546,1291,745
3501,0,0,16,0,-16
3502,0,0,3,0,-3
3503,0,0,25,0,-25
3504,1,0,9,0,-9
3505,0,0,30,0,-30
3506,1,1,1094,1284,190
3507,1,1,429,1336,907
3508,1,1,274,1686,1412
3509,0,0,87,0,-87
3510,0,0,201,0,-201
3511,1,0,36,0,-36
3512,1,1,317,1452,1135
3513,1,1,82,1309,1227
3514,1,1,826,1343,517
3515,1,0,11,0,-11
3516,0,0,167,0,-167
3517,0,0,53,0,-53
3518,1,0,15,0,-15
3519,1,0,18,0,-18
3520,1,0,32,0,-32
3521,0,0,89,0,-89
3522,0,0,37,0,-37
3523,0,0,35,0,-35
3524,1,1,3163,1662,-1501
3525,0,0,72,0,-72
3526,0,0,45,0,-45
3527,0,0,48,0,-48
3528,1,0,64,0,-64
3529,0,0,8,0,-8
3530,0,0,22,0,-22
3531,0,0,7,0,-7
3532,0,0,8,0,-8
3533,1,1,242,1356,1114
3534,0,0,0,0,0
3535,1,1,291,1341,1050
3536,1,1,428,2712,2284
3537,1,1,1921,1310,-611
3538,0,0,17,0,-17
3539,0,0,2,0,-2
3540,1,1,1326,2086,760
3541,0,0,122,0,-122
3542,0,0,65,0,-65
3543,0,0,8,0,-8
3544,1,1,988,1352,364
3545,1,0,39,0,-39
3546,1,0,34,0,-34
3547,0,0,23,0,-23
3548,1,0,23,0,-23
3549,0,0,32,0,-32
3550,1,0,51,0,-51
3551,1,0,211,0,-211
3552,1,0,112,0,-112
3553,1,1,505,1566,1061
3554,0,0,34,0,-34
3555,0,0,16,0,-16
3556,1,0,6,0,-6
3557,0,0,33,0,-33
3558,0,0,14,0,-14
3559,1,1,223,1241,1018
3560,1,1,40,1329,1289
3561,1,1,635,1432,797
3562,1,1,569,1334,765
3563,0,0,1,0,-1
3564,1,0,110,0,-110
3565,1,1,93,1476,1383
3566,1,1,150,1552,1402
3567,0,0,29,0,-29
3568,0,0,71,0,-71
3569,1,1,458,1393,935
3570,1,0,83,0,-83
3571,0,0,15,0,-15
3572,1,0,2,0,-2
3573,0,0,8,0,-8
3574,0,0,106,0,-106
3575,0,0,28,0,-28
3576,0,0,4,0,-4
3577,1,1,618,1749,1131
3578,0,0,0,0,0
3579,0,0,169,0,-169
3580,1,1,516,1776,1260
3581,1,1,173,1699,1526
3582,0,0,61,0,-61
3583,0,0,84,0,-84
3584,0,0,44,0,-44
3585,1,1,279,1702,1423
3586,0,0,46,0,-46
3587,0,0,37,0,-37
3588,1,1,107,1471,1364
3589,1,0,9,0,-9
3590,1,1,206,1373,1167
3591,1,1,300,1585,1285
3592,1,0,5,0,-5
3593,1,0,65,0,-65
3594,0,0,7,0,-7
3595,0,0,120,0,-120
3596,1,0,114,0,-114
3597,1,1,543,1340,797
3598,1,1,925,1429,504
3599,1,1,96,1312,1216
3600,1,1,568,1765,1197
3601,0,0,1,0,-1
3602,0,0,0,0,0
3603,1,1,475,2051,1576
3604,1,0,91,0,-91
3605,1,0,44,0,-44
3606,1,0,37,0,-37
3607,0,0,16,0,-16
3608,0,0,11,0,-11
3609,0,0,2,0,-2
3610,1,1,288,1665,1377
3611,1,0,6,0,-6
3612,0,0,18,0,-18
3613,1,0,105,0,-105
3614,1,0,70,0,-70
3615,0,0,237,0,-237
3616,1,1,669,1508,839
3617,1,0,122,0,-122
3618,1,0,27,0,-27
3619,0,0,43,0,-43
3620,1,0,95,0,-95
3621,0,0,19,0,-19
3622,1,1,996,2886,1890
3623,1,0,1,0,-1
3624,0,0,54,0,-54
3625,0,0,10,0,-10
3626,1,1,2319,1453,-866
3627,0,0,74,0,-74
3628,1,0,53,0,-53
3629,0,0,14,0,-14
3630,0,0,20,0,-20
3631,1,0,0,0,0
3632,1,0,61,0,-61
3633,0,0,7,0,-7
3634,1,0,6,0,-6
3635,0,0,25,0,-25
3636,1,0,33,0,-33
3637,0,0,66,0,-66
3638,1,1,442,1604,1162
3639,1,0,17,0,-17
3640,0,0,11,0,-11
3641,0,0,12,0,-12
3642,1,1,290,1540,1250
3643,0,0,170,0,-170
3644,1,1,173,1637,1464
3645,1,0,137,0,-137
3646,1,1,572,1528,956
3647,0,0,15,0,-15
3648,0,0,181,0,-181
3649,1,0,239,0,-239
3650,1,1,1248,1318,70
3651,0,0,203,0,-203
3652,1,1,112,1477,1365
3653,1,0,41,0,-41
3654,0,0,201,0,-201
3655,1,0,4,0,-4
3656,1,1,385,1617,1232
3657,1,1,640,1344,704
3658,0,0,25,0,-25
3659,1,0,10,0,-10
3660,0,0,6,0,-6
3661,1,1,433,1668,1235
3662,1,1,617,1216,599
3663,0,0,221,0,-221
3664,1,0,89,0,-89
3665,0,0,41,0,-41
3666,1,0,29,0,-29
3667,1,0,51,0,-51
3668,1,0,7,0,-7
3669,1,1,290,1297,1007
3670,0,0,39,0,-39
3671,0,0,29,0,-29
3672,0,0,11,0,-11
3673,1,1,149,1825,1676
3674,0,0,38,0,-38
3675,0,0,4,0,-4
3676,0,0,27,0,-27
3677,1,1,959,2081,1122
3678,0,0,36,0,-36
3679,1,0,14,0,-14
3680,0,0,108,0,-108
3681,1,0,21,0,-21
3682,0,0,10,0,-10
3683,0,0,106,0,-106
3684,0,0,4,0,-4
3685,1,1,561,1337,776
3686,1,0,129,0,-129
3687,0,0,143,0,-143
3688,1,1,121,1303,1182
3689,0,0,49,0,-49
3690,1,0,4,0,-4
3691,1,0,65,0,-65
3692,0,0,27,0,-27
3693,1,0,85,0,-85
3694,0,0,80,0,-80
3695,1,1,321,1500,1179
3696,0,0,61,0,-61
3697,1,1,1326,3551,2225
3698,0,0,2,0,-2
3699,0,0,74,0,-74
3700,1,1,874,1236,362
3701,1,1,156,1572,1416
3702,0,0,123,0,-123
3703,1,0,76,0,-76
3704,1,0,22,0,-22
3705,0,0,100,0,-100
3706,0,0,31,0,-31
3707,1,1,365,2170,1805
3708,1,1,234,1597,1363
3709,0,0,26,0,-26
3710,1,1,333,1277,944
3711,1,1,1099,1409,310
3712,0,0,74,0,-74
3713,1,1,78,1964,1886
3714,1,1,479,1309,830
3715,1,1,436,1521,1085
3716,1,0,15,0,-15
3717,0,0,74,0,-74
3718,1,0,120,0,-120
3719,1,1,520,1278,758
3720,1,0,4,0,-4
3721,1,0,13,0,-13
3722,1,0,78,0,-78
3723,1,1,187,1326,1139
3724,1,0,35,0,-35
3725,1,1,1044,1210,166
3726,1,1,156,1247,1091
3727,1,1,930,2560,1630
3728,1,1,314,1673,1359
3729,1,0,47,0,-47
3730,1,1,94,1631,1537
3731,1,0,2,0,-2
3732,1,1,1218,1216,-2
3733,0,0,65,0,-65
3734,0,0,110,0,-110
3735,1,0,3,0,-3
3736,0,0,9,0,-9
3737,1,0,56,0,-56
3738,0,0,69,0,-69
3739,0,0,51,0,-51
3740,1,0,9,0,-9
3741,0,0,66,0,-66
3742,0,0,55,0,-55
3743,0,0,42,0,-42
3744,0,0,165,0,-165
3745,1,1,470,1245,775
3746,0,0,52,0,-52
3747,0,0,11,0,-11
3748,1,0,101,0,-101
3749,1,1,460,1372,912
3750,0,0,45,0,-45
3751,0,0,11,0,-11
3752,1,0,4,0,-4
3753,0,0,143,0,-143
3754,1,0,36,0,-36
3755,0,0,1,0,-1
3756,1,1,109,2084,1975
3757,0,0,87,0,-87
3758,0,0,48,0,-48
3759,0,0,72,0,-72
3760,0,0,4,0,-4
3761,1,0,107,0,-107
3762,0,0,60,0,-60
3763,1,1,883,2093,1210
3764,1,1,1015,1788,773
3765,0,0,8,0,-8
3766,0,0,4,0,-4
3767,0,0,30,0,-30
3768,1,1,1719,1343,-376
3769,0,0,5,0,-5
3770,1,0,10,0,-10
3771,1,1,1080,1385,305
3772,0,0,27,0,-27
3773,1,1,1494,1560,66
3774,1,1,1529,1344,-185
3775,0,0,140,0,-140
3776,1,0,126,0,-126
3777,1,0,47,0,-47
3778,0,0,4,0,-4
3779,0,0,2,0,-2
3780,0,0,67,0,-67
3781,0,0,12,0,-12
3782,1,1,226,1391,1165
3783,1,0,64,0,-64
3784,1,1,449,2087,1638
3785,1,0,6,0,-6
3786,0,0,57,0,-57
3787,1,1,205,1229,1024
3788,1,1,867,1288,421
3789,0,0,8,0,-8
3790,0,0,50,0,-50
3791,0,0,4,0,-4
3792,1,1,911,1350,439
3793,1,0,19,0,-19
3794,1,0,29,0,-29
3795,1,0,121,0,-121
3796,1,0,43,0,-43
3797,0,0,3,0,-3
3798,1,0,67,0,-67
3799,1,1,578,1530,952
3800,0,0,19,0,-19
3801,1,1,133,4613,4480
3802,1,0,77,0,-77
3803,0,0,27,0,-27
3804,1,1,1053,1482,429
3805,1,0,7,0,-7
3806,1,0,23,0,-23
3807,1,0,16,0,-16
3808,1,1,173,1774,1601
3809,1,1,530,1282,752
3810,1,0,9,0,-9
3811,1,0,6,0,-6
3812,0,0,20,0,-20
3813,1,0,12,0,-12
3814,1,1,330,1630,1300
3815,0,0,35,0,-35
3816,0,0,150,0,-150
3817,0,0,73,0,-73
3818,0,0,42,0,-42
3819,0,0,58,0,-58
3820,0,0,17,0,-17
3821,0,0,70,0,-70
3822,1,1,529,1256,727
3823,0,0,123,0,-123
3824,1,0,1,0,-1
3825,0,0,101,0,-101
3826,1,1,626,1284,658
3827,1,1,154,1314,1160
3828,0,0,35,0,-35
3829,0,0,11,0,-11
3830,0,0,14,0,-14
3831,0,0,3,0,-3
3832,0,0,13,0,-13
3833,0,0,16,0,-16
3834,1,0,127,0,-127
3835,1,1,777,1654,877
3836,1,1,1039,1213,174
3837,1,1,813,1283,470
3838,0,0,14,0,-14
3839,1,0,23,0,-23
3840,0,0,103,0,-103
3841,1,1,653,2401,1748
3842,0,0,17,0,-17
3843,1,1,1433,1612,179
3844,1,1,691,1473,782
3845,0,0,28,0,-28
3846,1,1,400,1272,872
3847,0,0,80,0,-80
3848,1,1,100,1374,1274
3849,1,1,344,1230,886
3850,1,1,992,1702,710
3851,0,0,51,0,-51
3852,1,1,552,1420,868
3853,1,0,5,0,-5
3854,1,1,528,1293,765
3855,0,0,72,0,-72
3856,1,0,85,0,-85
3857,0,0,24,0,-24
3858,1,1,73,1332,1259
3859,0,0,28,0,-28
3860,1,0,41,0,-41
3861,1,0,66,0,-66
3862,1,0,48,0,-48
3863,0,0,25,0,-25
3864,1,0,37,0,-37
3865,1,0,16,0,-16
3866,1,1,64,1510,1446
3867,1,0,65,0,-65
3868,1,1,118,2368,2250
3869,0,0,20,0,-20
3870,1,1,818,1413,595
3871,1,0,32,0,-32
3872,1,0,16,0,-16
3873,1,0,97,0,-97
3874,1,1,52,1602,1550
3875,1,1,811,1630,819
3876,1,1,1649,2574,925
3877,1,0,118,0,-118
3878,0,0,64,0,-64
3879,1,0,13,0,-13
3880,0,0,28,0,-28
3881,0,0,54,0,-54
3882,0,0,133,0,-133
3883,0,0,34,0,-34
3884,1,1,131,1758,1627
3885,1,1,448,1326,878
3886,1,1,731,1938,1207
3887,0,0,23,0,-23
3888,0,0,131,0,-131
3889,0,0,88,0,-88
3890,1,0,8,0,-8
3891,1,1,510,2001,1491
3892,1,1,1169,1588,419
3893,0,0,28,0,-28
3894,1,0,2,0,-2
3895,0,0,32,0,-32
3896,0,0,16,0,-16
3897,1,1,525,2282,1757
3898,0,0,126,0,-126
3899,0,0,125,0,-125
3900,1,1,422,2553,2131
3901,1,0,14,0,-14
3902,1,0,62,0,-62
3903,0,0,31,0,-31
3904,1,0,37,0,-37
3905,0,0,87,0,-87
3906,1,0,11,0,-11
3907,1,1,849,1434,585
3908,0,0,14,0,-14
3909,1,1,296,2102,1806
3910,0,0,31,0,-31
3911,1,0,77,0,-77
3912,1,0,20,0,-20
3913,0,0,69,0,-69
3914,1,0,63,0,-63
3915,1,0,8,0,-8
3916,1,0,29,0,-29
3917,1,0,99,0,-99
3918,0,0,4,0,-4
3919,0,0,65,0,-65
3920,0,0,59,0,-59
3921,1,0,32,0,-32
3922,1,0,51,0,-51
3923,1,0,42,0,-42
3924,0,0,74,0,-74
3925,0,0,13,0,-13
3926,1,1,496,1403,907
3927,0,0,62,0,-62
3928,0,0,26,0,-26
3929,0,0,91,0,-91
3930,1,1,887,5382,4495
3931,0,0,45,0,-45
3932,1,0,93,0,-93
3933,1,0,58,0,-58
3934,0,0,20,0,-20
3935,1,0,108,0,-108
3936,1,1,69,1513,1444
3937,1,0,123,0,-123
3938,1,0,80,0,-80
3939,1,0,121,0,-121
3940,0,0,1,0,-1
3941,0,0,4,0,-4
3942,1,1,1438,1285,-153
3943,1,0,57,0,-57
3944,1,1,1330,1438,108
3945,0,0,107,0,-107
3946,0,0,15,0,-15
3947,0,0,18,0,-18
3948,1,0,0,0,0
3949,0,0,10,0,-10
3950,0,0,52,0,-52
3951,0,0,3,0,-3
3952,0,0,30,0,-30
3953,1,1,158,1534,1376
3954,1,1,337,1310,973
3955,1,0,18,0,-18
3956,1,0,16,0,-16
3957,0,0,115,0,-115
3958,1,0,58,0,-58
3959,0,0,9,0,-9
3960,1,1,52,1402,1350
3961,1,1,515,1317,802
3962,0,0,30,0,-30
3963,1,1,412,1478,1066
3964,1,0,14,0,-14
3965,1,0,19,0,-19
3966,1,1,657,1403,746
3967,1,1,329,1283,954
3968,1,1,143,4635,4492
3969,0,0,4,0,-4
3970,1,0,3,0,-3
3971,1,0,10,0,-10
3972,0,0,9,0,-9
3973,1,0,12,0,-12
3974,0,0,82,0,-82
3975,0,0,34,0,-34
3976,1,0,105,0,-105
3977,0,0,23,0,-23
3978,0,0,9,0,-9
3979,0,0,31,0,-31
3980,1,1,892,2367,1475
3981,1,1,1266,1299,33
3982,0,0,27,0,-27
3983,1,0,9,0,-9
3984,0,0,96,0,-96
3985,0,0,17,0,-17
3986,1,0,0,0,0
3987,1,0,1,0,-1
3988,1,0,19,0,-19
3989,1,0,5,0,-5
3990,0,0,97,0,-97
3991,1,1,80,1611,1531
3992,0,0,12,0,-12
3993,0,0,20,0,-20
3994,0,0,63,0,-63
3995,0,0,26,0,-26
3996,0,0,6,0,-6
3997,1,1,513,1384,871
3998,1,0,65,0,-65
3999,0,0,19,0,-19
4000,1,1,211,1472,1261
4001,1,1,1444,1355,-89
4002,0,0,69,0,-69
4003,0,0,107,0,-107
4004,1,1,160,1346,1186
4005,1,1,574,1249,675
4006,0,0,15,0,-15
4007,1,1,1133,1442,309
4008,0,0,24,0,-24
4009,1,1,339,1369,1030
4010,0,0,94,0,-94
4011,0,0,9,0,-9
4012,1,1,1055,1702,647
4013,1,1,248,1945,1697
4014,1,0,106,0,-106
4015,1,0,22,0,-22
4016,1,1,453,2097,1644
4017,1,0,18,0,-18
4018,1,1,372,1976,1604
4019,1,1,241,1314,1073
4020,1,0,58,0,-58
4021,1,1,271,1451,1180
4022,1,1,1224,1425,201
4023,0,0,64,0,-64
4024,1,0,1,0,-1
4025,1,1,1242,1532,290
4026,1,1,757,1403,646
4027,1,0,53,0,-53
4028,0,0,7,0,-7
4029,1,0,43,0,-43
4030,1,1,204,1751,1547
4031,0,0,38,0,-38
4032,1,1,37,1615,1578
4033,0,0,12,0,-12
4034,0,0,80,0,-80
4035,0,0,27,0,-27
4036,0,0,40,0,-40
4037,1,0,40,0,-40
4038,1,1,125,1290,1165
4039,0,0,76,0,-76
4040,0,0,47,0,-47
4041,0,0,3,0,-3
4042,1,1,339,1849,1510
4043,1,1,1567,2452,885
4044,0,0,26,0,-26
4045,1,1,1010,1221,211
4046,1,0,33,0,-33
4047,1,1,70,1636,1566
4048,0,0,25,0,-25
4049,1,0,155,0,-155
4050,0,0,7,0,-7
4051,1,1,358,2412,2054
4052,1,0,6,0,-6
4053,0,0,24,0,-24
4054,1,1,623,1309,686
4055,1,0,15,0,-15
4056,1,1,187,1206,1019
4057,1,0,62,0,-62
4058,1,0,15,0,-15
4059,1,1,1586,1599,13
4060,0,0,43,0,-43
4061,1,1,948,1348,400
4062,0,0,9,0,-9
4063,1,0,17,0,-17
4064,0,0,35,0,-35
4065,1,0,65,0,-65
4066,1,1,423,1257,834
4067,1,0,10,0,-10
4068,1,0,277,0,-277
4069,0,0,55,0,-55
4070,0,0,5,0,-5
4071,1,0,36,0,-36
4072,1,1,105,1233,1128
4073,0,0,3,0,-3
4074,0,0,63,0,-63
4075,1,0,28,0,-28
4076,1,0,4,0,-4
4077,0,0,23,0,-23
4078,1,1,1176,1281,105
4079,1,0,67,0,-67
4080,0,0,93,0,-93
4081,0,0,2,0,-2
4082,1,1,199,1339,1140
4083,1,0,28,0,-28
4084,1,0,62,0,-62
4085,1,1,874,1298,424
4086,0,0,7,0,-7
4087,1,1,1357,1449,92
4088,0,0,7,0,-7
4089,1,1,90,1554,1464
4090,0,0,39,0,-39
4091,1,0,3,0,-3
4092,1,0,12,0,-12
4093,1,1,1240,1585,345
4094,1,0,18,0,-18
4095,1,1,901,1437,536
4096,1,0,72,0,-72
4097,1,1,169,1220,1051
4098,1,0,11,0,-11
4099,1,0,1,0,-1
4100,0,0,0,0,0
4101,0,0,44,0,-44
4102,0,0,17,0,-17
4103,0,0,79,0,-79
4104,1,0,7,0,-7
4105,1,1,266,1227,961
4106,0,0,21,0,-21
4107,1,1,575,1219,644
4108,0,0,253,0,-253
4109,0,0,30,0,-30
4110,1,0,5,0,-5
4111,1,1,109,1256,1147
4112,0,0,180,0,-180
4113,0,0,15,0,-15
4114,1,1,755,1275,520
4115,1,1,682,1420,738
4116,1,0,61,0,-61
4117,0,0,27,0,-27
4118,1,1,594,1547,953
4119,0,0,15,0,-15
4120,0,0,67,0,-67
4121,1,1,475,1990,1515
4122,1,1,1950,1253,-697
4123,0,0,49,0,-49
4124,1,0,19,0,-19
4125,0,0,2,0,-2
4126,1,0,10,0,-10
4127,0,0,25,0,-25
4128,1,0,34,0,-34
4129,0,0,38,0,-38
4130,0,0,59,0,-59
4131,1,1,473,1245,772
4132,1,0,27,0,-27
4133,1,1,212,2148,1936
4134,0,0,23,0,-23
4135,1,1,140,1562,1422
4136,0,0,200,0,-200
4137,0,0,17,0,-17
4138,0,0,48,0,-48
4139,0,0,20,0,-20
4140,0,0,56,0,-56
4141,1,0,16,0,-16
4142,1,1,17,2424,2407
4143,1,1,2764,1279,-1485
4144,1,0,90,0,-90
4145,1,1,1017,1459,442
4146,1,1,680,1257,577
4147,1,0,96,0,-96
4148,1,1,504,4761,4257
4149,1,0,27,0,-27
4150,1,0,14,0,-14
4151,1,1,1326,1215,-111
4152,1,1,358,1611,1253
4153,0,0,8,0,-8
4154,0,0,37,0,-37
4155,0,0,57,0,-57
4156,0,0,22,0,-22
4157,1,0,0,0,0
4158,1,0,35,0,-35
4159,1,0,85,0,-85
4160,1,0,78,0,-78
4161,0,0,39,0,-39
4162,0,0,128,0,-128
4163,1,1,437,2963,2526
4164,0,0,18,0,-18
4165,0,0,76,0,-76
4166,1,0,30,0,-30
4167,0,0,113,0,-113
4168,1,0,19,0,-19
4169,1,1,214,2956,2742
4170,1,1,1128,1374,246
4171,0,0,48,0,-48
4172,1,0,2,0,-2
4173,1,1,59,1259,1200
4174,0,0,29,0,-29
4175,0,0,0,0,0
4176,0,0,43,0,-43
4177,1,0,4,0,-4
4178,1,0,19,0,-19
4179,0,0,13,0,-13
4180,0,0,43,0,-43
4181,0,0,96,0,-96
4182,0,0,17,0,-17
4183,1,1,144,1272,1128
4184,0,0,45,0,-45
4185,0,0,31,0,-31
4186,1,1,289,1778,1489
4187,0,0,56,0,-56
4188,0,0,202,0,-202
4189,1,1,501,1235,734
4190,0,0,135,0,-135
4191,0,0,99,0,-99
4192,1,1,342,1261,919
4193,1,0,1,0,-1
4194,0,0,68,0,-68
4195,0,0,8,0,-8
4196,1,1,410,1212,802
4197,1,0,99,0,-99
4198,0,0,27,0,-27
4199,0,0,69,0,-69
4200,0,0,122,0,-122
4201,1,0,8,0,-8
4202,1,0,78,0,-78
4203,0,0,76,0,-76
4204,1,1,540,1232,692
4205,0,0,4,0,-4
4206,1,0,4,0,-4
4207,1,1,301,1641,1340
4208,0,0,60,0,-60
4209,1,1,75,1380,1305
4210,1,0,26,0,-26
4211,0,0,4,0,-4
4212,1,0,24,0,-24
4213,0,0,24,0,-24
4214,0,0,75,0,-75
4215,0,0,83,0,-83
4216,1,1,997,2196,1199
4217,0,0,101,0,-101
4218,1,0,52,0,-52
4219,1,0,62,0,-62
4220,1,1,64,2167,2103
4221,0,0,1,0,-1
4222,0,0,2,0,-2
4223,1,0,199,0,-199
4224,1,1,210,1334,1124
4225,1,0,32,0,-32
4226,0,0,110,0,-110
4227,0,0,134,0,-134
4228,0,0,25,0,-25
4229,0,0,18,0,-18
4230,1,0,106,0,-106
4231,0,0,9,0,-9
4232,0,0,63,0,-63
4233,1,1,321,1355,1034
4234,0,0,13,0,-13
4235,1,1,720,1893,1173
4236,1,1,690,1700,1010
4237,1,1,146,1243,1097
4238,1,1,1009,1364,355
4239,0,0,14,0,-14
4240,0,0,2,0,-2
4241,0,0,11,0,-11
4242,0,0,5,0,-5
4243,0,0,107,0,-107
4244,1,1,28,1781,1753
4245,1,1,325,1734,1409
4246,0,0,17,0,-17
4247,1,1,311,1435,1124
4248,1,0,47,0,-47
4249,0,0,140,0,-140
4250,1,0,79,0,-79
4251,0,0,6,0,-6
4252,1,0,28,0,-28
4253,0,0,22,0,-22
4254,1,1,753,1218,465
4255,1,0,1,0,-1
4256,1,1,982,1668,686
4257,0,0,123,0,-123
4258,1,1,376,1348,972
4259,1,0,89,0,-89
4260,1,0,186,0,-186
4261,0,0,2,0,-2
4262,1,1,947,1212,265
4263,1,1,39,1279,1240
4264,0,0,26,0,-26
4265,1,0,15,0,-15
4266,1,1,404,2028,1624
4267,1,1,325,1238,913
4268,1,0,237,0,-237
4269,0,0,72,0,-72
4270,0,0,16,0,-16
4271,1,1,865,1359,494
4272,0,0,23,0,-23
4273,0,0,47,0,-47
4274,0,0,49,0,-49
4275,0,0,46,0,-46
4276,1,0,17,0,-17
4277,1,0,25,0,-25
4278,1,0,57,0,-57
4279,1,0,13,0,-13
4280,0,0,29,0,-29
4281,1,1,1809,1290,-519
4282,1,1,140,1216,1076
4283,0,0,398,0,-398
4284,0,0,209,0,-209
4285,1,0,1,0,-1
4286,0,0,121,0,-121
4287,1,0,44,0,-44
4288,1,0,24,0,-24
4289,0,0,1,0,-1
4290,1,0,64,0,-64
4291,1,0,2,0,-2
4292,0,0,108,0,-108
4293,0,0,32,0,-32
4294,1,0,20,0,-20
4295,0,0,55,0,-55
4296,1,0,68,0,-68
4297,1,1,345,1479,1134
4298,0,0,0,0,0
4299,1,0,192,0,-192
4300,1,0,4,0,-4
4301,1,0,82,0,-82
4302,0,0,0,0,0
4303,1,1,731,1453,722
4304,1,1,310,1414,1104
4305,1,1,246,1579,1333
4306,1,0,3,0,-3
4307,1,0,11,0,-11
4308,1,0,21,0,-21
4309,1,0,29,0,-29
4310,0,0,41,0,-41
4311,1,0,64,0,-64
4312,1,1,81,1257,1176
4313,1,0,22,0,-22
4314,1,1,1008,1342,334
4315,0,0,67,0,-67
4316,1,1,38,1751,1713
4317,1,1,1232,1220,-12
4318,1,0,21,0,-21
4319,1,0,27,0,-27
4320,0,0,0,0,0
4321,1,0,54,0,-54
4322,0,0,64,0,-64
4323,1,0,91,0,-91
4324,1,1,124,1287,1163
4325,1,0,1,0,-1
4326,0,0,5,0,-5
4327,0,0,3,0,-3
4328,1,0,99,0,-99
4329,0,0,24,0,-24
4330,0,0,114,0,-114
4331,1,0,22,0,-22
4332,1,1,18,1709,1691
4333,1,0,76,0,-76
4334,1,0,1,0,-1
4335,1,0,19,0,-19
4336,0,0,85,0,-85
4337,0,0,8,0,-8
4338,0,0,12,0,-12
4339,1,0,130,0,-130
4340,1,1,47,2207,2160
4341,1,1,72,1390,1318
4342,1,0,17,0,-17
4343,1,1,201,1340,1139
4344,1,0,29,0,-29
4345,1,0,9,0,-9
4346,0,0,10,0,-10
4347,1,1,265,1375,1110
4348,1,1,395,1798,1403
4349,0,0,50,0,-50
4350,1,1,670,1212,542
4351,1,1,504,1241,737
4352,1,1,1358,1477,119
4353,1,1,437,2604,2167
4354,1,0,363,0,-363
4355,1,0,46,0,-46
4356,1,0,53,0,-53
4357,0,0,23,0,-23
4358,0,0,72,0,-72
4359,0,0,120,0,-120
4360,1,1,533,1603,1070
4361,0,0,21,0,-21
4362,1,1,297,1475,1178
4363,0,0,2,0,-2
4364,1,1,680,1274,594
4365,0,0,61,0,-61
4366,0,0,3,0,-3
4367,0,0,126,0,-126
4368,1,1,748,1869,1121
4369,1,1,19,1380,1361
4370,1,0,26,0,-26
4371,0,0,25,0,-25
4372,0,0,7,0,-7
4373,1,0,12,0,-12
4374,0,0,15,0,-15
4375,0,0,8,0,-8
4376,1,0,53,0,-53
4377,1,1,591,1210,619
4378,1,0,27,0,-27
4379,0,0,68,0,-68
4380,1,1,700,1367,667
4381,1,1,2466,1529,-937
4382,0,0,113,0,-113
4383,1,0,14,0,-14
4384,0,0,51,0,-51
4385,0,0,1,0,-1
4386,0,0,12,0,-12
4387,1,0,32,0,-32
4388,0,0,64,0,-64
4389,0,0,38,0,-38
4390,1,1,1145,1468,323
4391,1,1,971,1410,439
4392,1,1,356,1212,856
4393,0,0,60,0,-60
4394,1,1,465,1581,1116
4395,0,0,14,0,-14
4396,0,0,23,0,-23
4397,1,0,63,0,-63
4398,1,1,713,1346,633
4399,0,0,118,0,-118
4400,1,0,116,0,-116
4401,1,1,286,1322,1036
4402,1,1,806,1837,1031
4403,1,1,346,1260,914
4404,0,0,79,0,-79
4405,1,1,3001,1424,-1577
4406,0,0,43,0,-43
4407,0,0,68,0,-68
4408,0,0,1,0,-1
4409,1,1,392,1388,996
4410,0,0,112,0,-112
4411,0,0,50,0,-50
4412,1,1,510,1432,922
4413,0,0,58,0,-58
4414,1,0,13,0,-13
4415,0,0,110,0,-110
4416,0,0,26,0,-26
4417,0,0,3,0,-3
4418,0,0,72,0,-72
4419,1,1,404,1453,1049
4420,0,0,6,0,-6
4421,1,1,94,1364,1270
4422,0,0,29,0,-29
4423,1,0,65,0,-65
4424,1,1,576,1575,999
4425,0,0,10,0,-10
4426,0,0,6,0,-6
4427,1,1,72,1899,1827
4428,1,1,1097,1367,270
4429,0,0,128,0,-128
4430,1,1,629,1834,1205
4431,1,1,903,1307,404
4432,1,1,644,1459,815
4433,1,1,246,1243,997
4434,0,0,114,0,-114
4435,1,0,162,0,-162
4436,0,0,141,0,-141
4437,1,1,231,1284,1053
4438,1,0,55,0,-55
4439,1,1,894,1554,660
4440,0,0,4,0,-4
4441,1,1,442,1302,860
4442,1,1,209,1467,1258
4443,0,0,56,0,-56
4444,0,0,70,0,-70
4445,0,0,64,0,-64
4446,1,0,1,0,-1
4447,1,0,40,0,-40
4448,1,1,646,1801,1155
4449,0,0,19,0,-19
4450,0,0,49,0,-49
4451,1,0,78,0,-78
4452,1,1,1255,1509,254
4453,0,0,31,0,-31
4454,1,1,1152,1253,101
4455,0,0,65,0,-65
4456,1,1,201,2159,1958
4457,0,0,21,0,-21
4458,1,1,703,1876,1173
4459,0,0,24,0,-24
4460,0,0,66,0,-66
4461,1,0,29,0,-29
4462,0,0,114,0,-114
4463,1,0,79,0,-79
4464,0,0,5,0,-5
4465,0,0,0,0,0
4466,1,0,16,0,-16
4467,1,1,2227,2082,-145
4468,1,0,180,0,-180
4469,1,0,229,0,-229
4470,1,0,17,0,-17
4471,1,1,1374,1414,40
4472,1,1,663,1346,683
4473,0,0,162,0,-162
4474,0,0,54,0,-54
4475,1,0,74,0,-74
4476,1,1,158,1843,1685
4477,1,0,119,0,-119
4478,1,0,180,0,-180
4479,1,0,89,0,-89
4480,0,0,14,0,-14
4481,0,0,19,0,-19
4482,0,0,4,0,-4
4483,0,0,49,0,-49
4484,1,0,77,0,-77
4485,1,0,18,0,-18
4486,1,1,556,2433,1877
4487,1,0,44,0,-44
4488,1,0,46,0,-46
4489,1,1,432,1525,1093
4490,0,0,6,0,-6
4491,0,0,82,0,-82
4492,0,0,352,0,-352
4493,1,0,2,0,-2
4494,0,0,87,0,-87
4495,1,0,39,0,-39
4496,1,0,25,0,-25
4497,1,0,3,0,-3
4498,1,0,17,0,-17
4499,0,0,16,0,-16
4500,1,1,1295,1502,207
4501,0,0,63,0,-63
4502,1,0,142,0,-142
4503,1,0,3,0,-3
4504,1,0,4,0,-4
4505,1,0,32,0,-32
4506,0,0,70,0,-70
4507,1,1,610,1383,773
4508,1,0,7,0,-7
4509,1,1,439,1305,866
4510,1,1,807,1579,772
4511,1,0,27,0,-27
4512,0,0,95,0,-95
4513,0,0,28,0,-28
4514,1,0,99,0,-99
4515,0,0,12,0,-12
4516,0,0,43,0,-43
4517,0,0,18,0,-18
4518,0,0,212,0,-212
4519,1,0,31,0,-31
4520,0,0,70,0,-70
4521,1,0,3,0,-3
4522,0,0,20,0,-20
4523,0,0,103,0,-103
4524,1,1,135,1277,1142
4525,1,0,95,0,-95
4526,0,0,38,0,-38
4527,1,1,349,1242,893
4528,1,1,180,1201,1021
4529,0,0,105,0,-105
4530,1,0,36,0,-36
4531,0,0,89,0,-89
4532,1,0,75,0,-75
4533,1,0,35,0,-35
4534,0,0,13,0,-13
4535,0,0,38,0,-38
4536,0,0,175,0,-175
4537,0,0,33,0,-33
4538,1,1,491,1335,844
4539,0,0,132,0,-132
4540,1,1,63,1672,1609
4541,1,1,350,1211,861
4542,0,0,32,0,-32
4543,1,1,813,1746,933
4544,0,0,31,0,-31
4545,0,0,23,0,-23
4546,1,1,226,1715,1489
4547,1,0,12,0,-12
4548,0,0,58,0,-58
4549,0,0,21,0,-21
4550,1,0,38,0,-38
4551,1,1,1390,1303,-87
4552,0,0,4,0,-4
4553,0,0,16,0,-16
4554,1,0,59,0,-59
4555,0,0,36,0,-36
4556,1,1,224,1272,1048
4557,1,1,1165,1374,209
4558,1,1,1237,1235,-2
4559,1,1,266,2197,1931
4560,1,1,706,1731,1025
4561,0,0,91,0,-91
4562,1,0,2,0,-2
4563,1,1,304,1940,1636
4564,1,1,725,1798,1073
4565,0,0,58,0,-58
4566,1,1,165,1255,1090
4567,1,1,414,1278,864
4568,1,1,221,2766,2545
4569,1,0,86,0,-86
4570,1,1,1121,1435,314
4571,1,1,863,1335,472
4572,1,1,780,1456,676
4573,1,0,104,0,-104
4574,1,0,20,0,-20
4575,1,0,36,0,-36
4576,1,0,17,0,-17
4577,0,0,65,0,-65
4578,0,0,7,0,-7
4579,1,1,736,1753,1017
4580,1,0,22,0,-22
4581,1,1,747,1592,845
4582,1,1,213,2308,2095
4583,1,0,36,0,-36
4584,0,0,111,0,-111
4585,1,0,6,0,-6
4586,1,0,10,0,-10
4587,1,1,842,1472,630
4588,1,1,815,1316,501
4589,1,0,68,0,-68
4590,0,0,32,0,-32
4591,1,0,41,0,-41
4592,1,0,6,0,-6
4593,0,0,58,0,-58
4594,1,1,1931,1344,-587
4595,1,0,118,0,-118
4596,1,1,227,1332,1105
4597,1,1,982,1361,379
4598,1,0,28,0,-28
4599,1,1,2165,3322,1157
4600,0,0,119,0,-119
4601,0,0,30,0,-30
4602,1,1,328,1278,950
4603,0,0,34,0,-34
4604,1,1,700,1207,507
4605,0,0,46,0,-46
4606,0,0,73,0,-73
4607,0,0,35,0,-35
4608,1,0,95,0,-95
4609,1,1,266,1601,1335
4610,1,1,1017,1211,194
4611,1,0,1,0,-1
4612,0,0,36,0,-36
4613,1,1,4585,1597,-2988
4614,1,1,1179,1644,465
4615,0,0,43,0,-43
4616,1,1,638,1436,798
4617,1,1,554,3771,3217
4618,0,0,33,0,-33
4619,0,0,39,0,-39
4620,1,1,99,1345,1246
4621,0,0,214,0,-214
4622,0,0,28,0,-28
4623,0,0,15,0,-15
4624,0,0,35,0,-35
4625,1,1,932,1914,982
4626,1,0,85,0,-85
4627,1,1,259,1394,1135
4628,1,0,32,0,-32
4629,1,1,303,1265,962
4630,1,0,27,0,-27
4631,1,1,142,2487,2345
4632,1,1,47,1669,1622
4633,1,0,83,0,-83
4634,1,0,92,0,-92
4635,1,1,218,1278,1060
4636,1,1,261,1463,1202
4637,0,0,3,0,-3
4638,1,0,2,0,-2
4639,1,0,29,0,-29
4640,1,0,75,0,-75
4641,1,0,21,0,-21
4642,1,0,3,0,-3
4643,1,0,193,0,-193
4644,1,0,90,0,-90
4645,1,0,6,0,-6
4646,1,0,37,0,-37
4647,0,0,8,0,-8
4648,1,1,131,1248,1117
4649,1,0,23,0,-23
4650,1,0,48,0,-48
4651,1,1,561,1326,765
4652,1,1,676,2548,1872
4653,1,0,24,0,-24
4654,1,1,125,1248,1123
4655,1,0,16,0,-16
4656,1,1,166,1659,1493
4657,1,1,314,1311,997
4658,1,1,434,1666,1232
4659,1,1,1310,1231,-79
4660,1,1,344,1462,1118
4661,0,0,27,0,-27
4662,1,0,15,0,-15
4663,0,0,2,0,-2
4664,1,0,110,0,-110
4665,1,1,190,1222,1032
4666,0,0,28,0,-28
4667,0,0,210,0,-210
4668,1,1,2660,1251,-1409
4669,0,0,47,0,-47
4670,1,1,78,1271,1193
4671,0,0,50,0,-50
4672,1,1,8,1798,1790
4673,1,1,427,1623,1196
4674,1,0,100,0,-100
4675,1,1,631,1579,948
4676,1,1,460,1820,1360
4677,1,0,1,0,-1
4678,1,1,499,3509,3010
4679,1,1,1527,1892,365
4680,0,0,0,0,0
4681,1,0,37,0,-37
4682,0,0,59,0,-59
4683,1,0,111,0,-111
4684,0,0,68,0,-68
4685,0,0,71,0,-71
4686,0,0,20,0,-20
4687,1,1,466,1593,1127
4688,0,0,89,0,-89
4689,0,0,111,0,-111
4690,0,0,141,0,-141
4691,1,0,18,0,-18
4692,1,0,85,0,-85
4693,0,0,6,0,-6
4694,0,0,65,0,-65
4695,0,0,84,0,-84
4696,1,1,1320,2467,1147
4697,1,1,128,1897,1769
4698,1,0,50,0,-50
4699,0,0,1,0,-1
4700,1,1,1231,1254,23
4701,1,0,13,0,-13
4702,1,1,152,2006,1854
4703,1,1,222,1328,1106
4704,1,1,243,1350,1107
4705,0,0,7,0,-7
4706,1,1,444,1330,886
4707,1,1,265,1747,1482
4708,1,0,6,0,-6
4709,1,0,30,0,-30
4710,1,0,81,0,-81
4711,0,0,63,0,-63
4712,1,0,38,0,-38
4713,1,0,24,0,-24
4714,0,0,65,0,-65
4715,1,1,1462,1289,-173
4716,0,0,61,0,-61
4717,0,0,70,0,-70
4718,0,0,16,0,-16
4719,0,0,10,0,-10
4720,1,0,46,0,-46
4721,1,1,88,1244,1156
4722,1,0,21,0,-21
4723,0,0,29,0,-29
4724,0,0,26,0,-26
4725,1,0,9,0,-9
4726,1,0,31,0,-31
4727,0,0,52,0,-52
4728,0,0,5,0,-5
4729,0,0,3,0,-3
4730,0,0,68,0,-68
4731,1,1,285,1201,916
4732,1,0,58,0,-58
4733,1,0,11,0,-11
4734,1,0,48,0,-48
4735,0,0,22,0,-22
4736,1,1,1143,1238,95
4737,1,1,1220,1213,-7
4738,1,1,65,2137,2072
4739,0,0,198,0,-198
4740,1,0,104,0,-104
4741,0,0,34,0,-34
4742,0,0,52,0,-52
4743,0,0,16,0,-16
4744,1,1,138,1245,1107
4745,0,0,12,0,-12
4746,0,0,36,0,-36
4747,1,1,1008,1330,322
4748,1,1,208,2254,2046
4749,0,0,25,0,-25
4750,1,1,596,1264,668
4751,0,0,9,0,-9
4752,0,0,5,0,-5
4753,0,0,9,0,-9
4754,1,0,7,0,-7
4755,0,0,40,0,-40
4756,0,0,12,0,-12
4757,1,1,52,1391,1339
4758,1,1,834,1356,522
4759,1,0,4,0,-4
4760,1,0,79,0,-79
4761,0,0,8,0,-8
4762,1,0,0,0,0
4763,1,1,77,1590,1513
4764,1,1,149,2784,2635
4765,0,0,15,0,-15
4766,1,0,65,0,-65
4767,0,0,97,0,-97
4768,1,0,4,0,-4
4769,1,1,951,1272,321
4770,0,0,17,0,-17
4771,1,0,28,0,-28
4772,1,0,28,0,-28
4773,1,1,783,1225,442
4774,1,1,1061,2870,1809
4775,0,0,273,0,-273
4776,1,0,216,0,-216
4777,0,0,23,0,-23
4778,1,1,1037,1252,215
4779,0,0,12,0,-12
4780,0,0,15,0,-15
4781,1,0,1,0,-1
4782,0,0,6,0,-6
4783,0,0,42,0,-42
4784,1,1,361,1238,877
4785,0,0,160,0,-160
4786,0,0,232,0,-232
4787,0,0,3,0,-3
4788,1,1,183,1595,1412
4789,0,0,67,0,-67
4790,1,0,2,0,-2
4791,1,0,49,0,-49
4792,1,1,1882,1303,-579
4793,1,0,279,0,-279
4794,1,0,17,0,-17
4795,1,0,73,0,-73
4796,0,0,27,0,-27
4797,1,1,457,1322,865
4798,1,0,37,0,-37
4799,1,0,18,0,-18
4800,0,0,71,0,-71
4801,1,1,372,1415,1043
4802,1,1,456,1293,837
4803,1,0,41,0,-41
4804,1,1,868,1814,946
4805,1,0,58,0,-58
4806,1,0,29,0,-29
4807,1,1,786,2603,1817
4808,0,0,103,0,-103
4809,0,0,28,0,-28
4810,1,0,5,0,-5
4811,0,0,27,0,-27
4812,1,0,94,0,-94
4813,1,1,933,1222,289
4814,0,0,73,0,-73
4815,1,0,193,0,-193
4816,0,0,1,0,-1
4817,0,0,61,0,-61
4818,1,0,23,0,-23
4819,1,1,805,1516,711
4820,1,1,228,1379,1151
4821,1,1,787,1566,779
4822,1,1,762,1894,1132
4823,1,0,27,0,-27
4824,1,1,1670,2516,846
4825,1,0,45,0,-45
4826,1,1,1507,1386,-121
4827,0,0,234,0,-234
4828,0,0,35,0,-35
4829,1,0,23,0,-23
4830,0,0,107,0,-107
4831,1,1,124,1421,1297
4832,1,0,10,0,-10
4833,0,0,53,0,-53
4834,1,1,2914,1393,-1521
4835,1,0,12,0,-12
4836,1,1,255,1350,1095
4837,0,0,24,0,-24
4838,0,0,23,0,-23
4839,0,0,104,0,-104
4840,0,0,0,0,0
4841,1,0,45,0,-45
4842,0,0,39,0,-39
4843,1,0,0,0,0
4844,0,0,37,0,-37
4845,1,0,6,0,-6
4846,0,0,0,0,0
4847,1,1,329,1706,1377
4848,1,0,11,0,-11
4849,1,0,1,0,-1
4850,1,1,100,1253,1153
4851,1,0,5,0,-5
4852,1,1,691,2168,1477
4853,1,0,94,0,-94
4854,1,0,61,0,-61
4855,0,0,52,0,-52
4856,1,1,438,2844,2406
4857,0,0,6,0,-6
4858,1,1,94,1673,1579
4859,1,1,73,1292,1219
4860,0,0,129,0,-129
4861,0,0,2,0,-2
4862,0,0,13,0,-13
4863,1,1,1046,1468,422
4864,1,1,440,2256,1816
4865,0,0,40,0,-40
4866,1,1,336,1287,951
4867,1,1,378,1597,1219
4868,1,0,14,0,-14
4869,1,1,605,1326,721
4870,1,1,787,1261,474
4871,1,0,2,0,-2
4872,0,0,8,0,-8
4873,1,0,22,0,-22
4874,1,1,1283,1755,472
4875,1,1,546,1333,787
4876,1,0,34,0,-34
4877,0,0,147,0,-147
4878,1,1,153,1677,1524
4879,0,0,1,0,-1
4880,0,0,47,0,-47
4881,1,1,765,1380,615
4882,0,0,110,0,-110
4883,1,0,15,0,-15
4884,0,0,97,0,-97
4885,1,1,877,1277,400
4886,1,1,198,1526,1328
4887,0,0,140,0,-140
4888,0,0,79,0,-79
4889,1,0,52,0,-52
4890,1,1,541,1223,682
4891,1,1,181,3105,2924
4892,1,0,96,0,-96
4893,1,0,102,0,-102
4894,0,0,127,0,-127
4895,1,1,3178,1254,-1924
4896,1,1,659,1235,576
4897,0,0,67,0,-67
4898,1,0,15,0,-15
4899,0,0,21,0,-21
4900,1,0,91,0,-91
4901,1,0,50,0,-50
4902,0,0,26,0,-26
4903,0,0,34,0,-34
4904,1,0,42,0,-42
4905,1,1,296,1357,1061
4906,1,0,118,0,-118
4907,0,0,5,0,-5
4908,0,0,56,0,-56
4909,1,1,48,1366,1318
4910,1,0,49,0,-49
4911,1,1,484,1570,1086
4912,0,0,67,0,-67
4913,0,0,52,0,-52
4914,0,0,2,0,-2
4915,0,0,62,0,-62
4916,1,0,57,0,-57
4917,1,1,246,1717,1471
4918,1,0,19,0,-19
4919,0,0,24,0,-24
4920,1,0,93,0,-93
4921,1,1,714,1246,532
4922,0,0,86,0,-86
4923,1,1,453,2555,2102
4924,0,0,5,0,-5
4925,1,1,1556,2121,565
4926,1,1,19,1241,1222
4927,0,0,1,0,-1
4928,1,1,632,1806,1174
4929,0,0,31,0,-31
4930,0,0,30,0,-30
4931,1,1,135,1241,1106
4932,1,0,55,0,-55
4933,1,0,42,0,-42
4934,1,0,138,0,-138
4935,0,0,77,0,-77
4936,0,0,102,0,-102
4937,1,1,222,1909,1687
4938,0,0,128,0,-128
4939,1,1,37,1451,1414
4940,1,0,179,0,-179
4941,1,0,123,0,-123
4942,1,1,594,1918,1324
4943,1,1,274,1369,1095
4944,0,0,14,0,-14
4945,1,0,40,0,-40
4946,1,1,512,2154,1642
4947,0,0,66,0,-66
4948,1,1,1010,1762,752
4949,0,0,177,0,-177
4950,1,1,137,1380,1243
4951,0,0,105,0,-105
4952,0,0,5,0,-5
4953,1,0,55,0,-55
4954,0,0,29,0,-29
4955,1,1,273,1319,1046
4956,1,0,263,0,-263
4957,1,1,134,1283,1149
4958,0,0,56,0,-56
4959,0,0,79,0,-79
4960,1,0,91,0,-91
4961,1,1,138,1503,1365
4962,1,0,20,0,-20
4963,1,0,49,0,-49
4964,1,1,145,1279,1134
4965,1,0,33,0,-33
4966,1,1,634,1231,597
4967,0,0,14,0,-14
4968,1,0,31,0,-31
4969,1,0,32,0,-32
4970,1,1,49,1543,1494
4971,1,1,167,1409,1242
4972,1,1,240,3543,3303
4973,1,1,312,1493,1181
4974,1,0,4,0,-4
4975,0,0,19,0,-19
4976,0,0,59,0,-59
4977,0,0,15,0,-15
4978,1,0,72,0,-72
4979,1,0,47,0,-47
4980,0,0,10,0,-10
4981,1,0,27,0,-27
4982,1,1,80,1963,1883
4983,0,0,35,0,-35
4984,0,0,45,0,-45
4985,1,1,399,1310,911
4986,0,0,6,0,-6
4987,1,0,76,0,-76
4988,1,1,829,1205,376
4989,1,0,1,0,-1
4990,1,1,837,1313,476
4991,1,0,21,0,-21
4992,1,0,62,0,-62
4993,1,1,930,1406,476
4994,1,1,136,2135,1999
4995,1,0,20,0,-20
4996,0,0,16,0,-16
4997,1,1,336,1921,1585
4998,0,0,0,0,0
4999,1,0,97,0,-97
5000,1,0,12,0,-12
5001,0,0,19,0,-19
5002,1,0,1,0,-1
5003,0,0,34,0,-34
5004,1,1,713,1498,785
5005,1,1,83,1263,1180
5006,1,0,10,0,-10
5007,0,0,67,0,-67
5008,0,0,51,0,-51
5009,1,0,101,0,-101
5010,1,1,795,1393,598
5011,1,0,17,0,-17
5012,1,1,2001,1642,-359
5013,1,0,21,0,-21
5014,1,0,28,0,-28
5015,1,0,172,0,-172
5016,0,0,27,0,-27
5017,0,0,151,0,-151
5018,1,1,269,1621,1352
5019,1,1,998,1200,202
5020,1,0,169,0,-169
5021,1,0,6,0,-6
5022,1,1,724,1653,929
5023,1,1,539,1891,1352
5024,1,0,103,0,-103
5025,0,0,67,0,-67
5026,0,0,9,0,-9
5027,1,0,39,0,-39
5028,0,0,30,0,-30
5029,1,0,6,0,-6
5030,1,0,54,0,-54
5031,0,0,209,0,-209
5032,0,0,26,0,-26
5033,1,1,835,1382,547
5034,1,0,40,0,-40
5035,1,1,748,1207,459
5036,0,0,49,0,-49
5037,0,0,45,0,-45
5038,1,0,165,0,-165
5039,1,0,9,0,-9
5040,1,1,150,1875,1725
5041,1,1,49,1392,1343
5042,1,0,30,0,-30
5043,0,0,4,0,-4
5044,1,0,92,0,-92
5045,1,0,35,0,-35
5046,0,0,220,0,-220
5047,1,0,79,0,-79
5048,1,0,26,0,-26
5049,1,0,50,0,-50
5050,0,0,46,0,-46
5051,1,0,63,0,-63
5052,0,0,20,0,-20
5053,0,0,60,0,-60
5054,1,0,41,0,-41
5055,0,0,12,0,-12
5056,1,0,9,0,-9
5057,1,0,15,0,-15
5058,1,0,3,0,-3
5059,0,0,125,0,-125
5060,1,0,98,0,-98
5061,1,1,1633,1208,-425
5062,0,0,113,0,-113
5063,1,1,752,1403,651
5064,1,1,152,1596,1444
5065,1,0,77,0,-77
5066,1,0,23,0,-23
5067,1,1,1273,1228,-45
5068,0,0,126,0,-126
5069,0,0,1,0,-1
5070,0,0,241,0,-241
5071,1,1,235,2336,2101
5072,1,1,409,1272,863
5073,1,1,783,1214,431
5074,1,1,1583,1496,-87
5075,0,0,14,0,-14
5076,0,0,16,0,-16
5077,1,1,92,3498,3406
5078,0,0,91,0,-91
5079,0,0,21,0,-21
5080,0,0,87,0,-87
5081,0,0,108,0,-108
5082,1,1,156,3119,2963
5083,0,0,111,0,-111
5084,1,1,313,1221,908
5085,0,0,55,0,-55
5086,0,0,4,0,-4
5087,1,1,144,2149,2005
5088,0,0,14,0,-14
5089,1,0,15,0,-15
5090,1,1,358,1281,923
5091,1,1,342,2527,2185
5092,1,0,60,0,-60
5093,0,0,6,0,-6
5094,0,0,58,0,-58
5095,1,0,38,0,-38
5096,1,1,186,1284,1098
5097,1,0,141,0,-141
5098,1,1,292,1268,976
5099,0,0,18,0,-18
5100,1,0,35,0,-35
5101,0,0,86,0,-86
5102,1,1,284,1229,945
5103,1,1,410,1468,1058
5104,1,1,470,1212,742
5105,0,0,54,0,-54
5106,1,1,1265,1468,203
5107,1,0,2,0,-2
5108,0,0,149,0,-149
5109,1,0,32,0,-32
5110,0,0,3,0,-3
5111,1,0,30,0,-30
5112,0,0,1,0,-1
5113,1,1,153,3138,2985
5114,0,0,26,0,-26
5115,1,0,5,0,-5
5116,1,0,69,0,-69
5117,1,0,83,0,-83
5118,1,1,349,1420,1071
5119,1,1,382,1452,1070
5120,1,0,13,0,-13
5121,0,0,8,0,-8
5122,0,0,16,0,-16
5123,1,0,16,0,-16
5124,1,0,20,0,-20
5125,1,0,25,0,-25
5126,1,1,2135,1491,-644
5127,0,0,30,0,-30
5128,0,0,33,0,-33
5129,1,0,35,0,-35
5130,1,1,178,1262,1084
5131,1,0,63,0,-63
5132,1,0,48,0,-48
5133,0,0,29,0,-29
5134,1,1,939,1381,442
5135,1,0,71,0,-71
5136,1,0,185,0,-185
5137,0,0,49,0,-49
5138,0,0,15,0,-15
5139,0,0,61,0,-61
5140,1,0,53,0,-53
5141,0,0,200,0,-200
5142,1,0,12,0,-12
5143,0,0,12,0,-12
5144,0,0,11,0,-11
5145,1,1,2495,2247,-248
5146,1,0,230,0,-230
5147,0,0,48,0,-48
5148,0,0,138,0,-138
5149,0,0,1,0,-1
5150,1,0,20,0,-20
5151,1,1,435,1341,906
5152,1,1,274,1402,1128
5153,0,0,89,0,-89
5154,0,0,53,0,-53
5155,1,1,83,1437,1354
5156,1,0,12,0,-12
5157,0,0,232,0,-232
5158,1,1,112,1635,1523
5159,0,0,24,0,-24
5160,1,1,735,1316,581
5161,1,1,641,1281,640
5162,0,0,153,0,-153
5163,0,0,44,0,-44
5164,1,0,45,0,-45
5165,1,1,286,1217,931
5166,0,0,138,0,-138
5167,0,0,6,0,-6
5168,1,1,404,1839,1435
5169,1,1,517,4159,3642
5170,1,0,10,0,-10
5171,0,0,88,0,-88
5172,1,0,9,0,-9
5173,1,1,329,1231,902
5174,1,0,75,0,-75
5175,0,0,6,0,-6
5176,0,0,3,0,-3
5177,1,1,177,1453,1276
5178,1,1,139,1300,1161
5179,0,0,44,0,-44
5180,1,0,29,0,-29
5181,1,1,140,1225,1085
5182,1,0,1,0,-1
5183,1,1,578,1502,924
5184,1,0,91,0,-91
5185,1,1,99,1536,1437
5186,0,0,33,0,-33
5187,1,0,5,0,-5
5188,1,1,1454,1392,-62
5189,1,0,68,0,-68
5190,0,0,71,0,-71
5191,1,1,507,1359,852
5192,0,0,33,0,-33
5193,1,1,1535,1253,-282
5194,1,0,1,0,-1
5195,1,1,128,1227,1099
5196,1,1,375,1456,1081
5197,1,0,0,0,0
5198,0,0,77,0,-77
5199,0,0,30,0,-30
5200,0,0,64,0,-64
5201,1,1,180,1369,1189
5202,0,0,50,0,-50
5203,0,0,22,0,-22
5204,1,1,1136,1362,226
5205,1,0,19,0,-19
5206,1,1,922,1807,885
5207,0,0,1,0,-1
5208,1,1,761,1255,494
5209,0,0,58,0,-58
5210,1,1,538,1712,1174
5211,1,1,438,1223,785
5212,1,0,136,0,-136
5213,0,0,22,0,-22
5214,0,0,6,0,-6
5215,0,0,18,0,-18
5216,0,0,1,0,-1
5217,1,0,76,0,-76
5218,0,0,8,0,-8
5219,1,0,45,0,-45
5220,0,0,63,0,-63
5221,1,1,142,1289,1147
5222,1,0,3,0,-3
5223,1,1,1364,1613,249
5224,0,0,49,0,-49
5225,0,0,167,0,-167
5226,1,0,4,0,-4
5227,1,1,315,1291,976
5228,1,1,515,6796,6281
5229,1,0,43,0,-43
5230,0,0,68,0,-68
5231,1,1,881,1728,847
5232,0,0,86,0,-86
5233,1,1,506,2359,1853
5234,0,0,69,0,-69
5235,0,0,106,0,-106
5236,0,0,82,0,-82
5237,1,0,43,0,-43
5238,1,0,15,0,-15
5239,1,0,32,0,-32
5240,0,0,48,0,-48
5241,1,0,43,0,-43
5242,1,1,1195,1489,294
5243,1,1,169,1336,1167
5244,1,0,150,0,-150
5245,1,0,22,0,-22
5246,1,1,371,1203,832
5247,1,1,1223,1230,7
5248,1,0,18,0,-18
5249,1,1,337,2391,2054
5250,1,0,154,0,-154
5251,1,0,27,0,-27
5252,0,0,53,0,-53
5253,0,0,13,0,-13
5254,0,0,45,0,-45
5255,0,0,20,0,-20
5256,1,0,32,0,-32
5257,0,0,12,0,-12
5258,1,1,82,1705,1623
5259,1,0,60,0,-60
5260,1,1,456,1605,1149
5261,0,0,14,0,-14
5262,1,0,52,0,-52
5263,1,1,213,1506,1293
5264,0,0,73,0,-73
5265,1,1,173,1522,1349
5266,1,1,772,1417,645
5267,0,0,65,0,-65
5268,0,0,79,0,-79
5269,1,1,557,1245,688
5270,1,1,309,1343,1034
5271,0,0,63,0,-63
5272,1,1,361,1602,1241
5273,1,1,92,1489,1397
5274,1,1,443,2119,1676
5275,1,1,158,1824,1666
5276,1,1,582,2343,1761
5277,0,0,1,0,-1
5278,1,1,941,1222,281
5279,1,1,560,1375,815
5280,0,0,2,0,-2
5281,0,0,26,0,-26
5282,1,0,7,0,-7
5283,0,0,63,0,-63
5284,0,0,18,0,-18
5285,1,1,235,1263,1028
5286,0,0,60,0,-60
5287,0,0,33,0,-33
5288,1,1,280,1448,1168
5289,1,1,7,1861,1854
5290,1,1,399,1363,964
5291,1,1,417,1292,875
5292,1,0,71,0,-71
5293,0,0,59,0,-59
5294,0,0,98,0,-98
5295,1,1,623,1269,646
5296,0,0,76,0,-76
5297,1,1,133,1319,1186
5298,1,1,1138,1641,503
5299,1,1,559,1419,860
5300,1,1,268,1301,1033
5301,0,0,77,0,-77
5302,1,1,784,1339,555
5303,1,0,5,0,-5
5304,1,0,4,0,-4
5305,0,0,18,0,-18
5306,0,0,56,0,-56
5307,1,0,154,0,-154
5308,1,1,478,1217,739
5309,0,0,61,0,-61
5310,0,0,60,0,-60
5311,1,1,1131,1593,462
5312,0,0,31,0,-31
5313,0,0,34,0,-34
5314,1,0,25,0,-25
5315,1,0,46,0,-46
5316,0,0,143,0,-143
5317,1,1,2181,1230,-951
5318,1,0,65,0,-65
5319,1,1,672,1311,639
5320,1,1,1724,5747,4023
5321,1,1,883,1355,472
5322,0,0,55,0,-55
5323,0,0,26,0,-26
5324,0,0,56,0,-56
5325,0,0,23,0,-23
5326,0,0,25,0,-25
5327,0,0,86,0,-86
5328,1,1,347,1667,1320
5329,1,1,1108,1278,170
5330,1,1,460,1302,842
5331,1,1,411,3585,3174
5332,0,0,90,0,-90
5333,1,0,122,0,-122
5334,0,0,8,0,-8
5335,0,0,11,0,-11
5336,1,0,172,0,-172
5337,1,1,684,1263,579
5338,0,0,64,0,-64
5339,1,1,941,1374,433
5340,0,0,32,0,-32
5341,1,0,23,0,-23
5342,0,0,22,0,-22
5343,1,0,2,0,-2
5344,1,0,2,0,-2
5345,1,1,819,1399,580
5346,1,1,654,1361,707
5347,1,1,1064,1231,167
5348,1,1,168,1551,1383
5349,1,1,208,1240,1032
5350,1,1,824,1259,435
5351,0,0,30,0,-30
5352,0,0,0,0,0
5353,1,0,20,0,-20
5354,1,1,1203,1337,134
5355,1,0,39,0,-39
5356,1,1,284,1257,973
5357,1,1,529,1357,828
5358,0,0,30,0,-30
5359,0,0,114,0,-114
5360,0,0,18,0,-18
5361,0,0,12,0,-12
5362,1,0,50,0,-50
5363,1,1,348,1351,1003
5364,0,0,18,0,-18
5365,1,1,215,1238,1023
5366,0,0,9,0,-9
5367,0,0,42,0,-42
5368,0,0,91,0,-91
5369,1,1,387,1247,860
5370,0,0,18,0,-18
5371,1,1,2257,1413,-844
5372,0,0,109,0,-109
5373,0,0,4,0,-4
5374,1,0,43,0,-43
5375,1,1,1164,1631,467
5376,1,0,8,0,-8
5377,1,0,56,0,-56
5378,0,0,28,0,-28
5379,1,1,526,1400,874
5380,1,1,935,1544,609
5381,1,1,248,1328,1080
5382,1,0,114,0,-114
5383,0,0,50,0,-50
5384,0,0,43,0,-43
5385,1,1,47,1487,1440
5386,1,1,144,1373,1229
5387,0,0,45,0,-45
5388,1,1,180,2404,2224
5389,1,1,324,1555,1231
5390,1,1,626,1392,766
5391,0,0,239,0,-239
5392,0,0,84,0,-84
5393,1,1,219,1374,1155
5394,1,1,69,1623,1554
5395,1,1,726,1205,479
5396,0,0,3,0,-3
5397,0,0,49,0,-49
5398,0,0,45,0,-45
5399,1,1,1488,1218,-270
5400,1,0,2,0,-2
5401,1,0,24,0,-24
5402,1,1,164,1428,1264
5403,0,0,51,0,-51
5404,1,0,25,0,-25
5405,1,1,1042,1251,209
5406,1,0,2,0,-2
5407,0,0,46,0,-46
5408,1,0,51,0,-51
5409,1,0,45,0,-45
5410,1,1,760,1391,631
5411,0,0,41,0,-41
5412,1,1,67,1208,1141
5413,0,0,75,0,-75
5414,1,0,51,0,-51
5415,0,0,28,0,-28
5416,0,0,34,0,-34
5417,1,0,9,0,-9
5418,1,1,978,1320,342
5419,1,0,15,0,-15
5420,1,1,96,1888,1792
5421,1,1,1413,1212,-201
5422,1,0,27,0,-27
5423,1,1,167,2480,2313
5424,0,0,42,0,-42
5425,1,1,761,1554,793
5426,1,1,651,2015,1364
5427,0,0,108,0,-108
5428,1,0,37,0,-37
5429,0,0,37,0,-37
5430,1,0,38,0,-38
5431,0,0,17,0,-17
5432,0,0,54,0,-54
5433,1,0,18,0,-18
5434,1,1,554,1215,661
5435,1,0,58,0,-58
5436,1,1,863,1528,665
5437,1,1,2000,1379,-621
5438,1,1,135,1755,1620
5439,1,0,90,0,-90
5440,1,0,48,0,-48
5441,0,0,6,0,-6
5442,0,0,7,0,-7
5443,1,0,74,0,-74
5444,0,0,132,0,-132
5445,1,0,195,0,-195
5446,1,1,411,1285,874
5447,0,0,33,0,-33
5448,1,1,680,1487,807
5449,1,0,147,0,-147
5450,0,0,66,0,-66
5451,1,1,713,1435,722
5452,0,0,60,0,-60
5453,1,0,97,0,-97
5454,0,0,78,0,-78
5455,1,0,22,0,-22
5456,1,1,143,1277,1134
5457,1,1,184,1709,1525
5458,1,1,1805,1336,-469
5459,1,0,76,0,-76
5460,1,1,299,1791,1492
5461,1,0,18,0,-18
5462,1,0,35,0,-35
5463,0,0,3,0,-3
5464,1,0,71,0,-71
5465,1,0,87,0,-87
5466,1,0,68,0,-68
5467,0,0,55,0,-55
5468,1,0,47,0,-47
5469,1,0,85,0,-85
5470,0,0,18,0,-18
5471,1,0,29,0,-29
5472,1,1,320,1481,1161
5473,0,0,26,0,-26
5474,1,1,390,3240,2850
5475,0,0,6,0,-6
5476,1,0,48,0,-48
5477,1,1,995,1313,318
5478,0,0,4,0,-4
5479,1,0,30,0,-30
5480,0,0,114,0,-114
5481,0,0,52,0,-52
5482,0,0,171,0,-171
5483,1,0,13,0,-13
5484,0,0,65,0,-65
5485,1,0,14,0,-14
5486,1,1,3070,1326,-1744
5487,0,0,40,0,-40
5488,1,1,176,1770,1594
5489,1,0,7,0,-7
5490,1,0,64,0,-64
5491,0,0,68,0,-68
5492,1,1,32,2737,2705
5493,0,0,5,0,-5
5494,1,1,398,1504,1106
5495,1,1,536,1251,715
5496,1,0,7,0,-7
5497,0,0,7,0,-7
5498,0,0,94,0,-94
5499,0,0,5,0,-5
5500,1,1,1328,1793,465
5501,1,0,8,0,-8
5502,0,0,5,0,-5
5503,0,0,22,0,-22
5504,1,0,119,0,-119
5505,1,1,1455,1368,-87
5506,1,0,48,0,-48
5507,0,0,1,0,-1
5508,1,0,32,0,-32
5509,1,0,50,0,-50
5510,1,1,390,1447,1057
5511,0,0,69,0,-69
5512,0,0,15,0,-15
5513,0,0,35,0,-35
5514,1,1,238,1311,1073
5515,1,1,811,1237,426
5516,1,0,29,0,-29
5517,1,1,935,1399,464
5518,1,1,650,1277,627
5519,1,1,600,1431,831
5520,0,0,20,0,-20
5521,1,1,496,1569,1073
5522,1,1,1143,1982,839
5523,0,0,22,0,-22
5524,1,0,20,0,-20
5525,0,0,2,0,-2
5526,1,1,887,1406,519
5527,0,0,60,0,-60
5528,0,0,45,0,-45
5529,0,0,62,0,-62
5530,0,0,47,0,-47
5531,0,0,29,0,-29
5532,1,1,413,1669,1256
5533,0,0,38,0,-38
5534,1,1,148,1293,1145
5535,1,1,614,1668,1054
5536,1,1,251,1338,1087
5537,1,1,453,1433,980
5538,1,1,567,1622,1055
5539,1,1,157,1315,1158
5540,1,1,569,2254,1685
5541,1,0,2,0,-2
5542,1,1,312,1395,1083
5543,0,0,34,0,-34
5544,0,0,1,0,-1
5545,1,1,248,1638,1390
5546,1,1,31,1347,1316
5547,0,0,114,0,-114
5548,0,0,68,0,-68
5549,1,1,654,1305,651
5550,1,0,109,0,-109
5551,1,1,321,1300,979
5552,1,1,21,1356,1335
5553,1,1,100,1258,1158
5554,1,0,146,0,-146
5555,0,0,42,0,-42
5556,1,0,18,0,-18
5557,1,0,84,0,-84
5558,0,0,20,0,-20
5559,0,0,22,0,-22
5560,0,0,32,0,-32
5561,1,0,27,0,-27
5562,1,0,14,0,-14
5563,1,0,36,0,-36
5564,0,0,13,0,-13
5565,1,1,165,1774,1609
5566,0,0,7,0,-7
5567,0,0,86,0,-86
5568,1,1,212,1466,1254
5569,1,0,106,0,-106
5570,0,0,47,0,-47
5571,0,0,58,0,-58
5572,0,0,105,0,-105
5573,1,0,57,0,-57
5574,1,1,1361,5933,4572
5575,1,1,1324,2018,694
5576,1,1,1122,1264,142
5577,1,0,77,0,-77
5578,0,0,17,0,-17
5579,0,0,90,0,-90
5580,1,1,1238,1264,26
5581,0,0,22,0,-22
5582,0,0,0,0,0
5583,0,0,22,0,-22
5584,0,0,49,0,-49
5585,0,0,11,0,-11
5586,0,0,7,0,-7
5587,1,0,102,0,-102
5588,0,0,141,0,-141
5589,0,0,16,0,-16
5590,1,1,303,1570,1267
5591,1,1,389,1324,935
5592,1,1,389,1544,1155
5593,1,1,1414,1343,-71
5594,0,0,58,0,-58
5595,0,0,66,0,-66
5596,1,1,670,1699,1029
5597,1,0,110,0,-110
5598,0,0,50,0,-50
5599,1,1,261,1390,1129
5600,0,0,58,0,-58
5601,0,0,32,0,-32
5602,1,0,40,0,-40
5603,1,1,1050,1217,167
5604,1,0,123,0,-123
5605,1,1,426,1207,781
5606,1,1,88,1582,1494
5607,1,1,466,1329,863
5608,0,0,101,0,-101
5609,0,0,10,0,-10
5610,1,1,1173,1403,230
5611,1,0,0,0,0
5612,1,0,128,0,-128
5613,1,1,1528,1303,-225
5614,1,1,352,1429,1077
5615,1,0,124,0,-124
5616,0,0,38,0,-38
5617,1,1,57,1311,1254
5618,1,0,46,0,-46
5619,1,0,50,0,-50
5620,0,0,45,0,-45
5621,1,1,364,1238,874
5622,0,0,1,0,-1
5623,0,0,110,0,-110
5624,1,0,9,0,-9
5625,1,1,1578,1366,-212
5626,1,0,83,0,-83
5627,0,0,83,0,-83
5628,0,0,5,0,-5
5629,0,0,10,0,-10
5630,0,0,12,0,-12
5631,0,0,1,0,-1
5632,1,0,6,0,-6
5633,1,1,1558,1234,-324
5634,0,0,114,0,-114
5635,1,1,497,1804,1307
5636,0,0,16,0,-16
5637,1,1,291,1423,1132
5638,1,1,1035,1535,500
5639,0,0,18,0,-18
5640,1,1,333,1381,1048
5641,1,0,11,0,-11
5642,0,0,24,0,-24
5643,0,0,1,0,-1
5644,1,1,1056,1438,382
5645,1,0,46,0,-46
5646,1,1,366,1458,1092
5647,1,1,1265,1639,374
5648,0,0,1,0,-1
5649,1,1,478,2536,2058
5650,0,0,77,0,-77
5651,0,0,17,0,-17
5652,1,1,625,1451,826
5653,1,0,284,0,-284
5654,1,1,701,1681,980
5655,0,0,28,0,-28
5656,0,0,339,0,-339
5657,0,0,0,0,0
5658,0,0,67,0,-67
5659,1,1,285,1551,1266
5660,0,0,47,0,-47
5661,0,0,31,0,-31
5662,1,1,172,1518,1346
5663,1,1,601,1248,647
5664,1,1,320,1664,1344
5665,1,0,39,0,-39
5666,1,0,36,0,-36
5667,1,0,88,0,-88
5668,1,1,114,1227,1113
5669,1,1,78,1584,1506
5670,1,0,3,0,-3
5671,0,0,67,0,-67
5672,0,0,147,0,-147
5673,0,0,61,0,-61
5674,0,0,8,0,-8
5675,1,0,90,0,-90
5676,1,0,65,0,-65
5677,0,0,115,0,-115
5678,0,0,145,0,-145
5679,1,0,7,0,-7
5680,1,0,21,0,-21
5681,1,1,978,1955,977
5682,1,0,23,0,-23
5683,0,0,12,0,-12
5684,1,1,575,3145,2570
5685,0,0,114,0,-114
5686,1,0,59,0,-59
5687,1,1,91,1293,1202
5688,0,0,6,0,-6
5689,1,0,6,0,-6
5690,1,0,52,0,-52
5691,1,1,73,1383,1310
5692,0,0,9,0,-9
5693,1,1,1265,2885,1620
5694,0,0,52,0,-52
5695,0,0,16,0,-16
5696,1,0,97,0,-97
5697,1,0,35,0,-35
5698,0,0,12,0,-12
5699,1,0,101,0,-101
5700,0,0,24,0,-24
5701,1,0,15,0,-15
5702,1,1,1488,1399,-89
5703,1,1,131,1390,1259
5704,1,0,68,0,-68
5705,1,1,630,1879,1249
5706,1,1,256,1517,1261
5707,1,0,2,0,-2
5708,1,1,342,1454,1112
5709,1,1,936,1295,359
5710,1,0,13,0,-13
5711,1,1,793,1286,493
5712,1,1,349,1301,952
5713,0,0,123,0,-123
5714,1,1,42,1211,1169
5715,0,0,67,0,-67
5716,1,0,0,0,0
5717,0,0,113,0,-113
5718,1,1,426,1213,787
5719,0,0,59,0,-59
5720,0,0,75,0,-75
5721,1,1,777,2705,1928
5722,0,0,16,0,-16
5723,1,1,170,1286,1116
5724,0,0,45,0,-45
5725,0,0,20,0,-20
5726,1,1,489,4042,3553
5727,0,0,11,0,-11
5728,0,0,70,0,-70
5729,1,0,1,0,-1
5730,1,1,58,1287,1229
5731,0,0,31,0,-31
5732,1,0,16,0,-16
5733,1,0,73,0,-73
5734,1,0,23,0,-23
5735,1,1,371,1264,893
5736,0,0,20,0,-20
5737,1,1,220,1201,981
5738,0,0,38,0,-38
5739,1,0,241,0,-241
5740,1,1,43,1215,1172
5741,0,0,67,0,-67
5742,0,0,0,0,0
5743,0,0,11,0,-11
5744,1,1,255,1233,978
5745,1,0,26,0,-26
5746,1,0,2,0,-2
5747,1,0,57,0,-57
5748,0,0,39,0,-39
5749,0,0,112,0,-112
5750,1,1,114,1272,1158
5751,1,1,286,1969,1683
5752,0,0,14,0,-14
5753,0,0,70,0,-70
5754,1,1,527,1356,829
5755,1,1,1004,1363,359
5756,0,0,56,0,-56
5757,0,0,12,0,-12
5758,1,1,943,1223,280
5759,1,0,20,0,-20
5760,0,0,69,0,-69
5761,1,1,670,1246,576
5762,0,0,34,0,-34
5763,1,1,81,1718,1637
5764,1,1,545,2503,1958
5765,1,1,161,1499,1338
5766,0,0,125,0,-125
5767,1,1,76,2670,2594
5768,0,0,15,0,-15
5769,0,0,16,0,-16
5770,1,1,2261,1269,-992
5771,1,0,110,0,-110
5772,1,1,472,2018,1546
5773,1,1,1926,1509,-417
5774,0,0,14,0,-14
5775,1,0,45,0,-45
5776,0,0,35,0,-35
5777,1,0,5,0,-5
5778,0,0,4,0,-4
5779,1,1,2485,2217,-268
5780,1,0,41,0,-41
5781,1,1,855,1393,538
5782,0,0,86,0,-86
5783,0,0,9,0,-9
5784,1,0,151,0,-151
5785,1,1,242,1296,1054
5786,1,1,682,1446,764
